country_fr,iso3c,year,week,deaths_total,deaths_covid,baseline,diff_totals,diff_totals_perc
Autriche,AUT,2016,1,1634,NA,1835,-201,-10.95367847411444
Autriche,AUT,2016,2,1626,NA,1879,-253,-13.46460883448643
Autriche,AUT,2016,3,1608,NA,1774,-166,-9.357384441939121
Autriche,AUT,2016,4,1578,NA,1736,-158,-9.101382488479262
Autriche,AUT,2016,5,1609,NA,1814,-205,-11.300992282249172
Autriche,AUT,2016,6,1650,NA,1814,-164,-9.040793825799339
Autriche,AUT,2016,7,1621,NA,1768,-147,-8.314479638009049
Autriche,AUT,2016,8,1581,NA,1772,-191,-10.778781038374719
Autriche,AUT,2016,9,1714,NA,1799,-85,-4.724847137298499
Autriche,AUT,2016,10,1532,NA,1730,-198,-11.445086705202312
Autriche,AUT,2016,11,1516,NA,1698,-182,-10.71849234393404
Autriche,AUT,2016,12,1499,NA,1574,-75,-4.7649301143583225
Autriche,AUT,2016,13,1598,NA,1626,-28,-1.7220172201722017
Autriche,AUT,2016,14,1562,NA,1581,-19,-1.2017710309930425
Autriche,AUT,2016,15,1520,NA,1542,-22,-1.4267185473411155
Autriche,AUT,2016,16,1413,NA,1501,-88,-5.862758161225849
Autriche,AUT,2016,17,1460,NA,1451,9,0.6202618883528601
Autriche,AUT,2016,18,1447,NA,1468,-21,-1.430517711171662
Autriche,AUT,2016,19,1486,NA,1436,50,3.4818941504178276
Autriche,AUT,2016,20,1453,NA,1464,-11,-0.7513661202185792
Autriche,AUT,2016,21,1505,NA,1428,77,5.392156862745098
Autriche,AUT,2016,22,1402,NA,1442,-40,-2.7739251040221915
Autriche,AUT,2016,23,1360,NA,1406,-46,-3.2716927453769555
Autriche,AUT,2016,24,1348,NA,1429,-81,-5.668299510146956
Autriche,AUT,2016,25,1452,NA,1438,14,0.9735744089012517
Autriche,AUT,2016,26,1338,NA,1406,-68,-4.836415362731152
Autriche,AUT,2016,27,1328,NA,1422,-94,-6.610407876230662
Autriche,AUT,2016,28,1323,NA,1353,-30,-2.2172949002217295
Autriche,AUT,2016,29,1458,NA,1468,-10,-0.6811989100817438
Autriche,AUT,2016,30,1424,NA,1453,-29,-1.9958706125258088
Autriche,AUT,2016,31,1390,NA,1520,-130,-8.552631578947368
Autriche,AUT,2016,32,1359,NA,1408,-49,-3.4801136363636362
Autriche,AUT,2016,33,1394,NA,1403,-9,-0.6414825374198148
Autriche,AUT,2016,34,1408,NA,1448,-40,-2.7624309392265194
Autriche,AUT,2016,35,1414,NA,1414,0,0
Autriche,AUT,2016,36,1380,NA,1374,6,0.43668122270742354
Autriche,AUT,2016,37,1392,NA,1419,-27,-1.9027484143763214
Autriche,AUT,2016,38,1376,NA,1414,-38,-2.6874115983026874
Autriche,AUT,2016,39,1442,NA,1487,-45,-3.026227303295225
Autriche,AUT,2016,40,1469,NA,1514,-45,-2.97225891677675
Autriche,AUT,2016,41,1556,NA,1546,10,0.646830530401035
Autriche,AUT,2016,42,1607,NA,1511,96,6.353408338848444
Autriche,AUT,2016,43,1522,NA,1512,10,0.6613756613756614
Autriche,AUT,2016,44,1484,NA,1533,-49,-3.1963470319634704
Autriche,AUT,2016,45,1541,NA,1522,19,1.2483574244415243
Autriche,AUT,2016,46,1616,NA,1559,57,3.6561898652982685
Autriche,AUT,2016,47,1550,NA,1551,-1,-0.06447453255963895
Autriche,AUT,2016,48,1601,NA,1561,40,2.5624599615631007
Autriche,AUT,2016,49,1619,NA,1626,-7,-0.43050430504305043
Autriche,AUT,2016,50,1670,NA,1629,41,2.5168815224063845
Autriche,AUT,2016,51,1847,NA,1682,165,9.80975029726516
Autriche,AUT,2016,52,2160,NA,1783,377,21.144139091418957
Autriche,AUT,2017,1,2293,NA,1835,458,24.959128065395095
Autriche,AUT,2017,2,2340,NA,1879,461,24.534326769558277
Autriche,AUT,2017,3,2060,NA,1774,286,16.1217587373168
Autriche,AUT,2017,4,1938,NA,1736,202,11.63594470046083
Autriche,AUT,2017,5,2045,NA,1814,231,12.734288864388093
Autriche,AUT,2017,6,1874,NA,1814,60,3.307607497243661
Autriche,AUT,2017,7,1750,NA,1768,-18,-1.0180995475113122
Autriche,AUT,2017,8,1807,NA,1772,35,1.9751693002257338
Autriche,AUT,2017,9,1696,NA,1799,-103,-5.725403001667593
Autriche,AUT,2017,10,1614,NA,1730,-116,-6.705202312138728
Autriche,AUT,2017,11,1542,NA,1698,-156,-9.187279151943462
Autriche,AUT,2017,12,1535,NA,1574,-39,-2.4777636594663277
Autriche,AUT,2017,13,1489,NA,1626,-137,-8.425584255842558
Autriche,AUT,2017,14,1537,NA,1581,-44,-2.783048703352309
Autriche,AUT,2017,15,1532,NA,1542,-10,-0.648508430609598
Autriche,AUT,2017,16,1475,NA,1501,-26,-1.73217854763491
Autriche,AUT,2017,17,1440,NA,1451,-11,-0.7580978635423846
Autriche,AUT,2017,18,1527,NA,1468,59,4.0190735694822886
Autriche,AUT,2017,19,1434,NA,1436,-2,-0.1392757660167131
Autriche,AUT,2017,20,1501,NA,1464,37,2.527322404371585
Autriche,AUT,2017,21,1327,NA,1428,-101,-7.072829131652661
Autriche,AUT,2017,22,1456,NA,1442,14,0.9708737864077669
Autriche,AUT,2017,23,1312,NA,1406,-94,-6.685633001422476
Autriche,AUT,2017,24,1421,NA,1429,-8,-0.5598320503848845
Autriche,AUT,2017,25,1476,NA,1438,38,2.642559109874826
Autriche,AUT,2017,26,1419,NA,1406,13,0.9246088193456615
Autriche,AUT,2017,27,1413,NA,1422,-9,-0.6329113924050633
Autriche,AUT,2017,28,1346,NA,1353,-7,-0.5173688100517368
Autriche,AUT,2017,29,1475,NA,1468,7,0.4768392370572207
Autriche,AUT,2017,30,1375,NA,1453,-78,-5.368203716448726
Autriche,AUT,2017,31,1616,NA,1520,96,6.315789473684211
Autriche,AUT,2017,32,1334,NA,1408,-74,-5.255681818181818
Autriche,AUT,2017,33,1380,NA,1403,-23,-1.639344262295082
Autriche,AUT,2017,34,1472,NA,1448,24,1.6574585635359116
Autriche,AUT,2017,35,1329,NA,1414,-85,-6.011315417256012
Autriche,AUT,2017,36,1318,NA,1374,-56,-4.075691411935954
Autriche,AUT,2017,37,1426,NA,1419,7,0.49330514446793516
Autriche,AUT,2017,38,1407,NA,1414,-7,-0.49504950495049505
Autriche,AUT,2017,39,1496,NA,1487,9,0.605245460659045
Autriche,AUT,2017,40,1481,NA,1514,-33,-2.179656538969617
Autriche,AUT,2017,41,1529,NA,1546,-17,-1.0996119016817594
Autriche,AUT,2017,42,1453,NA,1511,-58,-3.8385175380542687
Autriche,AUT,2017,43,1489,NA,1512,-23,-1.5211640211640212
Autriche,AUT,2017,44,1551,NA,1533,18,1.1741682974559686
Autriche,AUT,2017,45,1490,NA,1522,-32,-2.102496714848883
Autriche,AUT,2017,46,1505,NA,1559,-54,-3.463758819756254
Autriche,AUT,2017,47,1570,NA,1551,19,1.2250161186331399
Autriche,AUT,2017,48,1531,NA,1561,-30,-1.9218449711723256
Autriche,AUT,2017,49,1632,NA,1626,6,0.36900369003690037
Autriche,AUT,2017,50,1554,NA,1629,-75,-4.6040515653775325
Autriche,AUT,2017,51,1653,NA,1682,-29,-1.7241379310344827
Autriche,AUT,2017,52,1646,NA,1783,-137,-7.683679192372406
Autriche,AUT,2018,1,1767,NA,1835,-68,-3.7057220708446867
Autriche,AUT,2018,2,1842,NA,1879,-37,-1.9691325172964342
Autriche,AUT,2018,3,1786,NA,1774,12,0.6764374295377678
Autriche,AUT,2018,4,1714,NA,1736,-22,-1.2672811059907834
Autriche,AUT,2018,5,1870,NA,1814,56,3.0871003307607494
Autriche,AUT,2018,6,1938,NA,1814,124,6.8357221609702314
Autriche,AUT,2018,7,1881,NA,1768,113,6.391402714932126
Autriche,AUT,2018,8,1951,NA,1772,179,10.10158013544018
Autriche,AUT,2018,9,2021,NA,1799,222,12.340188993885493
Autriche,AUT,2018,10,1965,NA,1730,235,13.583815028901732
Autriche,AUT,2018,11,1946,NA,1698,248,14.605418138987044
Autriche,AUT,2018,12,1641,NA,1574,67,4.256670902160101
Autriche,AUT,2018,13,1766,NA,1626,140,8.61008610086101
Autriche,AUT,2018,14,1617,NA,1581,36,2.2770398481973433
Autriche,AUT,2018,15,1560,NA,1542,18,1.1673151750972763
Autriche,AUT,2018,16,1557,NA,1501,56,3.7308461025982673
Autriche,AUT,2018,17,1383,NA,1451,-68,-4.686423156443833
Autriche,AUT,2018,18,1434,NA,1468,-34,-2.316076294277929
Autriche,AUT,2018,19,1372,NA,1436,-64,-4.456824512534819
Autriche,AUT,2018,20,1342,NA,1464,-122,-8.333333333333332
Autriche,AUT,2018,21,1383,NA,1428,-45,-3.1512605042016806
Autriche,AUT,2018,22,1415,NA,1442,-27,-1.872399445214979
Autriche,AUT,2018,23,1433,NA,1406,27,1.9203413940256047
Autriche,AUT,2018,24,1392,NA,1429,-37,-2.589223233030091
Autriche,AUT,2018,25,1401,NA,1438,-37,-2.5730180806675937
Autriche,AUT,2018,26,1414,NA,1406,8,0.5689900426742532
Autriche,AUT,2018,27,1441,NA,1422,19,1.3361462728551337
Autriche,AUT,2018,28,1404,NA,1353,51,3.7694013303769403
Autriche,AUT,2018,29,1511,NA,1468,43,2.9291553133514987
Autriche,AUT,2018,30,1455,NA,1453,2,0.13764624913971094
Autriche,AUT,2018,31,1615,NA,1520,95,6.25
Autriche,AUT,2018,32,1532,NA,1408,124,8.806818181818182
Autriche,AUT,2018,33,1430,NA,1403,27,1.924447612259444
Autriche,AUT,2018,34,1460,NA,1448,12,0.8287292817679558
Autriche,AUT,2018,35,1414,NA,1414,0,0
Autriche,AUT,2018,36,1376,NA,1374,2,0.1455604075691412
Autriche,AUT,2018,37,1452,NA,1419,33,2.3255813953488373
Autriche,AUT,2018,38,1421,NA,1414,7,0.49504950495049505
Autriche,AUT,2018,39,1436,NA,1487,-51,-3.429724277067922
Autriche,AUT,2018,40,1553,NA,1514,39,2.5759577278731833
Autriche,AUT,2018,41,1509,NA,1546,-37,-2.393272962483829
Autriche,AUT,2018,42,1488,NA,1511,-23,-1.5221707478491064
Autriche,AUT,2018,43,1491,NA,1512,-21,-1.3888888888888888
Autriche,AUT,2018,44,1561,NA,1533,28,1.82648401826484
Autriche,AUT,2018,45,1501,NA,1522,-21,-1.3797634691195795
Autriche,AUT,2018,46,1556,NA,1559,-3,-0.19243104554201412
Autriche,AUT,2018,47,1531,NA,1551,-20,-1.2894906511927788
Autriche,AUT,2018,48,1525,NA,1561,-36,-2.3062139654067906
Autriche,AUT,2018,49,1656,NA,1626,30,1.8450184501845017
Autriche,AUT,2018,50,1626,NA,1629,-3,-0.1841620626151013
Autriche,AUT,2018,51,1639,NA,1682,-43,-2.5564803804994054
Autriche,AUT,2018,52,1689,NA,1783,-94,-5.272013460459899
Autriche,AUT,2019,1,1647,NA,1835,-188,-10.245231607629428
Autriche,AUT,2019,2,1709,NA,1879,-170,-9.047365620010645
Autriche,AUT,2019,3,1641,NA,1774,-133,-7.497181510710258
Autriche,AUT,2019,4,1713,NA,1736,-23,-1.3248847926267282
Autriche,AUT,2019,5,1732,NA,1814,-82,-4.5203969128996695
Autriche,AUT,2019,6,1796,NA,1814,-18,-0.9922822491730982
Autriche,AUT,2019,7,1820,NA,1768,52,2.941176470588235
Autriche,AUT,2019,8,1751,NA,1772,-21,-1.1851015801354403
Autriche,AUT,2019,9,1764,NA,1799,-35,-1.9455252918287937
Autriche,AUT,2019,10,1811,NA,1730,81,4.682080924855491
Autriche,AUT,2019,11,1790,NA,1698,92,5.418138987043581
Autriche,AUT,2019,12,1619,NA,1574,45,2.8589580686149936
Autriche,AUT,2019,13,1651,NA,1626,25,1.5375153751537516
Autriche,AUT,2019,14,1607,NA,1581,26,1.644528779253637
Autriche,AUT,2019,15,1556,NA,1542,14,0.9079118028534372
Autriche,AUT,2019,16,1558,NA,1501,57,3.79746835443038
Autriche,AUT,2019,17,1521,NA,1451,70,4.824259131633356
Autriche,AUT,2019,18,1462,NA,1468,-6,-0.4087193460490463
Autriche,AUT,2019,19,1453,NA,1436,17,1.1838440111420612
Autriche,AUT,2019,20,1558,NA,1464,94,6.420765027322404
Autriche,AUT,2019,21,1497,NA,1428,69,4.831932773109244
Autriche,AUT,2019,22,1495,NA,1442,53,3.6754507628294033
Autriche,AUT,2019,23,1520,NA,1406,114,8.108108108108109
Autriche,AUT,2019,24,1554,NA,1429,125,8.74737578726382
Autriche,AUT,2019,25,1424,NA,1438,-14,-0.9735744089012517
Autriche,AUT,2019,26,1454,NA,1406,48,3.4139402560455197
Autriche,AUT,2019,27,1507,NA,1422,85,5.977496483825598
Autriche,AUT,2019,28,1338,NA,1353,-15,-1.1086474501108647
Autriche,AUT,2019,29,1430,NA,1468,-38,-2.588555858310627
Autriche,AUT,2019,30,1557,NA,1453,104,7.157604955264969
Autriche,AUT,2019,31,1457,NA,1520,-63,-4.144736842105263
Autriche,AUT,2019,32,1406,NA,1408,-2,-0.14204545454545456
Autriche,AUT,2019,33,1407,NA,1403,4,0.2851033499643621
Autriche,AUT,2019,34,1453,NA,1448,5,0.3453038674033149
Autriche,AUT,2019,35,1501,NA,1414,87,6.152758132956153
Autriche,AUT,2019,36,1423,NA,1374,49,3.566229985443959
Autriche,AUT,2019,37,1407,NA,1419,-12,-0.8456659619450317
Autriche,AUT,2019,38,1452,NA,1414,38,2.6874115983026874
Autriche,AUT,2019,39,1574,NA,1487,87,5.850706119704102
Autriche,AUT,2019,40,1555,NA,1514,41,2.7080581241743724
Autriche,AUT,2019,41,1592,NA,1546,46,2.975420439844761
Autriche,AUT,2019,42,1497,NA,1511,-14,-0.9265387160820648
Autriche,AUT,2019,43,1545,NA,1512,33,2.1825396825396823
Autriche,AUT,2019,44,1536,NA,1533,3,0.19569471624266144
Autriche,AUT,2019,45,1555,NA,1522,33,2.1681997371879107
Autriche,AUT,2019,46,1558,NA,1559,-1,-0.06414368184733803
Autriche,AUT,2019,47,1553,NA,1551,2,0.1289490651192779
Autriche,AUT,2019,48,1586,NA,1561,25,1.6015374759769379
Autriche,AUT,2019,49,1599,NA,1626,-27,-1.6605166051660518
Autriche,AUT,2019,50,1667,NA,1629,38,2.332719459791283
Autriche,AUT,2019,51,1591,NA,1682,-91,-5.410225921521997
Autriche,AUT,2019,52,1636,NA,1783,-147,-8.244531688166013
Autriche,AUT,2020,1,1609,0,1835,-226,-12.316076294277929
Autriche,AUT,2020,2,1702,0,1879,-177,-9.419904204364023
Autriche,AUT,2020,3,1797,0,1774,23,1.2965050732807215
Autriche,AUT,2020,4,1778,0,1736,42,2.4193548387096775
Autriche,AUT,2020,5,1947,0,1814,133,7.33186328555678
Autriche,AUT,2020,6,1678,0,1814,-136,-7.497243660418963
Autriche,AUT,2020,7,1721,0,1768,-47,-2.658371040723982
Autriche,AUT,2020,8,1715,0,1772,-57,-3.216704288939052
Autriche,AUT,2020,9,1768,0,1799,-31,-1.7231795441912174
Autriche,AUT,2020,10,1744,0,1730,14,0.8092485549132947
Autriche,AUT,2020,11,1718,3,1698,20,1.1778563015312131
Autriche,AUT,2020,12,1836,22,1574,262,16.645489199491742
Autriche,AUT,2020,13,1764,83,1626,138,8.487084870848708
Autriche,AUT,2020,14,1828,112,1581,247,15.62302340290955
Autriche,AUT,2020,15,1793,148,1542,251,16.277561608300907
Autriche,AUT,2020,16,1701,94,1501,200,13.324450366422386
Autriche,AUT,2020,17,1583,87,1451,132,9.097174362508614
Autriche,AUT,2020,18,1477,51,1468,9,0.6130790190735695
Autriche,AUT,2020,19,1510,20,1436,74,5.153203342618385
Autriche,AUT,2020,20,1475,9,1464,11,0.7513661202185792
Belgique,BEL,2016,1,2244,NA,2373,-129,-5.436156763590392
Belgique,BEL,2016,2,2234,NA,2408,-174,-7.225913621262459
Belgique,BEL,2016,3,2295,NA,2397,-102,-4.25531914893617
Belgique,BEL,2016,4,2263,NA,2400,-137,-5.708333333333333
Belgique,BEL,2016,5,2180,NA,2476,-296,-11.954765751211632
Belgique,BEL,2016,6,2127,NA,2429,-302,-12.433100041169205
Belgique,BEL,2016,7,2121,NA,2432,-311,-12.787828947368421
Belgique,BEL,2016,8,2230,NA,2416,-186,-7.698675496688742
Belgique,BEL,2016,9,2336,NA,2520,-184,-7.301587301587302
Belgique,BEL,2016,10,2264,NA,2452,-188,-7.6672104404567705
Belgique,BEL,2016,11,2248,NA,2336,-88,-3.767123287671233
Belgique,BEL,2016,12,2364,NA,2308,56,2.4263431542461005
Belgique,BEL,2016,13,2273,NA,2216,57,2.572202166064982
Belgique,BEL,2016,14,2080,NA,2109,-29,-1.375059269796112
Belgique,BEL,2016,15,2160,NA,2064,96,4.651162790697675
Belgique,BEL,2016,16,2049,NA,2026,23,1.1352418558736426
Belgique,BEL,2016,17,1996,NA,2018,-22,-1.0901883052527255
Belgique,BEL,2016,18,2087,NA,2014,73,3.624627606752731
Belgique,BEL,2016,19,2065,NA,2022,43,2.126607319485658
Belgique,BEL,2016,20,1926,NA,1982,-56,-2.825428859737639
Belgique,BEL,2016,21,1946,NA,1975,-29,-1.4683544303797469
Belgique,BEL,2016,22,1885,NA,1938,-53,-2.7347781217750256
Belgique,BEL,2016,23,1856,NA,1862,-6,-0.322234156820623
Belgique,BEL,2016,24,1851,NA,1825,26,1.4246575342465753
Belgique,BEL,2016,25,1920,NA,1928,-8,-0.4149377593360996
Belgique,BEL,2016,26,1846,NA,1899,-53,-2.790942601369142
Belgique,BEL,2016,27,1899,NA,1954,-55,-2.8147389969293757
Belgique,BEL,2016,28,1933,NA,1850,83,4.486486486486487
Belgique,BEL,2016,29,2030,NA,1932,98,5.072463768115942
Belgique,BEL,2016,30,1917,NA,2060,-143,-6.941747572815533
Belgique,BEL,2016,31,1801,NA,1912,-111,-5.805439330543933
Belgique,BEL,2016,32,1788,NA,1845,-57,-3.089430894308943
Belgique,BEL,2016,33,1976,NA,1856,120,6.4655172413793105
Belgique,BEL,2016,34,2120,NA,1938,182,9.39112487100103
Belgique,BEL,2016,35,1866,NA,1905,-39,-2.047244094488189
Belgique,BEL,2016,36,1835,NA,1866,-31,-1.6613076098606645
Belgique,BEL,2016,37,1938,NA,1851,87,4.700162074554295
Belgique,BEL,2016,38,1769,NA,1892,-123,-6.501057082452431
Belgique,BEL,2016,39,1906,NA,1902,4,0.2103049421661409
Belgique,BEL,2016,40,1904,NA,1968,-64,-3.2520325203252036
Belgique,BEL,2016,41,2065,NA,2020,45,2.2277227722772275
Belgique,BEL,2016,42,2041,NA,1992,49,2.459839357429719
Belgique,BEL,2016,43,2025,NA,1980,45,2.272727272727273
Belgique,BEL,2016,44,2088,NA,1956,132,6.748466257668712
Belgique,BEL,2016,45,2093,NA,2020,73,3.6138613861386135
Belgique,BEL,2016,46,2177,NA,2072,105,5.0675675675675675
Belgique,BEL,2016,47,2143,NA,2126,17,0.7996237064910631
Belgique,BEL,2016,48,2191,NA,2125,66,3.1058823529411765
Belgique,BEL,2016,49,2221,NA,2208,13,0.588768115942029
Belgique,BEL,2016,50,2221,NA,2248,-27,-1.2010676156583628
Belgique,BEL,2016,51,2321,NA,2298,23,1.0008703220191473
Belgique,BEL,2016,52,2418,NA,2293,125,5.451373746184038
Belgique,BEL,2017,1,2557,NA,2373,184,7.753898019384745
Belgique,BEL,2017,2,2735,NA,2408,327,13.579734219269103
Belgique,BEL,2017,3,2645,NA,2397,248,10.346266166040884
Belgique,BEL,2017,4,2691,NA,2400,291,12.125
Belgique,BEL,2017,5,2950,NA,2476,474,19.143780290791597
Belgique,BEL,2017,6,2691,NA,2429,262,10.786331823795802
Belgique,BEL,2017,7,2631,NA,2432,199,8.182565789473683
Belgique,BEL,2017,8,2389,NA,2416,-27,-1.1175496688741722
Belgique,BEL,2017,9,2315,NA,2520,-205,-8.134920634920634
Belgique,BEL,2017,10,2138,NA,2452,-314,-12.805872756933114
Belgique,BEL,2017,11,2036,NA,2336,-300,-12.842465753424658
Belgique,BEL,2017,12,2106,NA,2308,-202,-8.752166377816291
Belgique,BEL,2017,13,2068,NA,2216,-148,-6.678700361010831
Belgique,BEL,2017,14,1969,NA,2109,-140,-6.638217164532954
Belgique,BEL,2017,15,1954,NA,2064,-110,-5.329457364341085
Belgique,BEL,2017,16,1917,NA,2026,-109,-5.380059230009872
Belgique,BEL,2017,17,2079,NA,2018,61,3.022794846382557
Belgique,BEL,2017,18,2091,NA,2014,77,3.8232373386295926
Belgique,BEL,2017,19,2009,NA,2022,-13,-0.6429277942631058
Belgique,BEL,2017,20,2110,NA,1982,128,6.458123107971746
Belgique,BEL,2017,21,2009,NA,1975,34,1.7215189873417722
Belgique,BEL,2017,22,1981,NA,1938,43,2.2187822497420022
Belgique,BEL,2017,23,1815,NA,1862,-47,-2.524167561761547
Belgique,BEL,2017,24,1868,NA,1825,43,2.356164383561644
Belgique,BEL,2017,25,2101,NA,1928,173,8.973029045643154
Belgique,BEL,2017,26,1821,NA,1899,-78,-4.107424960505529
Belgique,BEL,2017,27,1901,NA,1954,-53,-2.712384851586489
Belgique,BEL,2017,28,1847,NA,1850,-3,-0.16216216216216214
Belgique,BEL,2017,29,1827,NA,1932,-105,-5.434782608695652
Belgique,BEL,2017,30,1897,NA,2060,-163,-7.9126213592233015
Belgique,BEL,2017,31,1808,NA,1912,-104,-5.439330543933055
Belgique,BEL,2017,32,1826,NA,1845,-19,-1.029810298102981
Belgique,BEL,2017,33,1784,NA,1856,-72,-3.8793103448275863
Belgique,BEL,2017,34,1951,NA,1938,13,0.6707946336429308
Belgique,BEL,2017,35,1924,NA,1905,19,0.9973753280839894
Belgique,BEL,2017,36,1883,NA,1866,17,0.9110396570203645
Belgique,BEL,2017,37,1823,NA,1851,-28,-1.5126958400864399
Belgique,BEL,2017,38,1908,NA,1892,16,0.8456659619450317
Belgique,BEL,2017,39,1963,NA,1902,61,3.207150368033649
Belgique,BEL,2017,40,1955,NA,1968,-13,-0.660569105691057
Belgique,BEL,2017,41,2059,NA,2020,39,1.9306930693069306
Belgique,BEL,2017,42,2007,NA,1992,15,0.7530120481927711
Belgique,BEL,2017,43,1913,NA,1980,-67,-3.383838383838384
Belgique,BEL,2017,44,1892,NA,1956,-64,-3.2719836400818
Belgique,BEL,2017,45,1939,NA,2020,-81,-4.00990099009901
Belgique,BEL,2017,46,2078,NA,2072,6,0.28957528957528955
Belgique,BEL,2017,47,2114,NA,2126,-12,-0.5644402634054563
Belgique,BEL,2017,48,2080,NA,2125,-45,-2.1176470588235294
Belgique,BEL,2017,49,2276,NA,2208,68,3.0797101449275366
Belgique,BEL,2017,50,2325,NA,2248,77,3.425266903914591
Belgique,BEL,2017,51,2272,NA,2298,-26,-1.1314186248912097
Belgique,BEL,2017,52,2350,NA,2293,57,2.4858264282599216
Belgique,BEL,2018,1,2382,NA,2373,9,0.37926675094816686
Belgique,BEL,2018,2,2317,NA,2408,-91,-3.77906976744186
Belgique,BEL,2018,3,2336,NA,2397,-61,-2.5448477263245723
Belgique,BEL,2018,4,2253,NA,2400,-147,-6.125
Belgique,BEL,2018,5,2355,NA,2476,-121,-4.886914378029079
Belgique,BEL,2018,6,2353,NA,2429,-76,-3.128859613009469
Belgique,BEL,2018,7,2565,NA,2432,133,5.46875
Belgique,BEL,2018,8,2628,NA,2416,212,8.774834437086094
Belgique,BEL,2018,9,3002,NA,2520,482,19.126984126984127
Belgique,BEL,2018,10,3016,NA,2452,564,23.00163132137031
Belgique,BEL,2018,11,2724,NA,2336,388,16.60958904109589
Belgique,BEL,2018,12,2594,NA,2308,286,12.391681109185441
Belgique,BEL,2018,13,2460,NA,2216,244,11.010830324909747
Belgique,BEL,2018,14,2203,NA,2109,94,4.4570886676149835
Belgique,BEL,2018,15,2175,NA,2064,111,5.377906976744186
Belgique,BEL,2018,16,2044,NA,2026,18,0.8884501480750246
Belgique,BEL,2018,17,1953,NA,2018,-65,-3.221010901883053
Belgique,BEL,2018,18,1867,NA,2014,-147,-7.298907646474677
Belgique,BEL,2018,19,1980,NA,2022,-42,-2.0771513353115725
Belgique,BEL,2018,20,1860,NA,1982,-122,-6.15539858728557
Belgique,BEL,2018,21,1951,NA,1975,-24,-1.2151898734177216
Belgique,BEL,2018,22,1953,NA,1938,15,0.7739938080495357
Belgique,BEL,2018,23,1811,NA,1862,-51,-2.7389903329752956
Belgique,BEL,2018,24,1734,NA,1825,-91,-4.986301369863014
Belgique,BEL,2018,25,1779,NA,1928,-149,-7.728215767634855
Belgique,BEL,2018,26,1950,NA,1899,51,2.6856240126382307
Belgique,BEL,2018,27,2080,NA,1954,126,6.448311156601842
Belgique,BEL,2018,28,1833,NA,1850,-17,-0.9189189189189189
Belgique,BEL,2018,29,1988,NA,1932,56,2.898550724637681
Belgique,BEL,2018,30,2107,NA,2060,47,2.2815533980582523
Belgique,BEL,2018,31,2125,NA,1912,213,11.140167364016737
Belgique,BEL,2018,32,2000,NA,1845,155,8.401084010840108
Belgique,BEL,2018,33,1887,NA,1856,31,1.670258620689655
Belgique,BEL,2018,34,1824,NA,1938,-114,-5.88235294117647
Belgique,BEL,2018,35,1825,NA,1905,-80,-4.199475065616798
Belgique,BEL,2018,36,1909,NA,1866,43,2.304394426580922
Belgique,BEL,2018,37,1811,NA,1851,-40,-2.1609940572663424
Belgique,BEL,2018,38,1970,NA,1892,78,4.12262156448203
Belgique,BEL,2018,39,1831,NA,1902,-71,-3.732912723449001
Belgique,BEL,2018,40,1965,NA,1968,-3,-0.1524390243902439
Belgique,BEL,2018,41,2006,NA,2020,-14,-0.6930693069306931
Belgique,BEL,2018,42,1957,NA,1992,-35,-1.7570281124497993
Belgique,BEL,2018,43,1918,NA,1980,-62,-3.1313131313131315
Belgique,BEL,2018,44,1907,NA,1956,-49,-2.505112474437628
Belgique,BEL,2018,45,2049,NA,2020,29,1.4356435643564358
Belgique,BEL,2018,46,2017,NA,2072,-55,-2.654440154440154
Belgique,BEL,2018,47,2060,NA,2126,-66,-3.1044214487300095
Belgique,BEL,2018,48,2107,NA,2125,-18,-0.8470588235294116
Belgique,BEL,2018,49,2173,NA,2208,-35,-1.585144927536232
Belgique,BEL,2018,50,2233,NA,2248,-15,-0.6672597864768683
Belgique,BEL,2018,51,2263,NA,2298,-35,-1.5230635335073976
Belgique,BEL,2018,52,2251,NA,2293,-42,-1.831661578717837
Belgique,BEL,2019,1,2308,NA,2373,-65,-2.7391487568478716
Belgique,BEL,2019,2,2347,NA,2408,-61,-2.5332225913621262
Belgique,BEL,2019,3,2312,NA,2397,-85,-3.546099290780142
Belgique,BEL,2019,4,2395,NA,2400,-5,-0.20833333333333334
Belgique,BEL,2019,5,2421,NA,2476,-55,-2.221324717285945
Belgique,BEL,2019,6,2544,NA,2429,115,4.734458624948538
Belgique,BEL,2019,7,2409,NA,2432,-23,-0.9457236842105263
Belgique,BEL,2019,8,2418,NA,2416,2,0.08278145695364239
Belgique,BEL,2019,9,2428,NA,2520,-92,-3.650793650793651
Belgique,BEL,2019,10,2389,NA,2452,-63,-2.569331158238173
Belgique,BEL,2019,11,2335,NA,2336,-1,-0.04280821917808219
Belgique,BEL,2019,12,2167,NA,2308,-141,-6.109185441941074
Belgique,BEL,2019,13,2063,NA,2216,-153,-6.9043321299638984
Belgique,BEL,2019,14,2183,NA,2109,74,3.508771929824561
Belgique,BEL,2019,15,1969,NA,2064,-95,-4.602713178294573
Belgique,BEL,2019,16,2095,NA,2026,69,3.405725567620928
Belgique,BEL,2019,17,2046,NA,2018,28,1.3875123885034688
Belgique,BEL,2019,18,2011,NA,2014,-3,-0.14895729890764647
Belgique,BEL,2019,19,2034,NA,2022,12,0.5934718100890208
Belgique,BEL,2019,20,2034,NA,1982,52,2.6236125126135215
Belgique,BEL,2019,21,1995,NA,1975,20,1.0126582278481013
Belgique,BEL,2019,22,1933,NA,1938,-5,-0.2579979360165119
Belgique,BEL,2019,23,1966,NA,1862,104,5.5853920515574655
Belgique,BEL,2019,24,1847,NA,1825,22,1.2054794520547945
Belgique,BEL,2019,25,1913,NA,1928,-15,-0.7780082987551867
Belgique,BEL,2019,26,1980,NA,1899,81,4.265402843601896
Belgique,BEL,2019,27,1935,NA,1954,-19,-0.9723643807574206
Belgique,BEL,2019,28,1788,NA,1850,-62,-3.3513513513513513
Belgique,BEL,2019,29,1882,NA,1932,-50,-2.587991718426501
Belgique,BEL,2019,30,2318,NA,2060,258,12.524271844660195
Belgique,BEL,2019,31,1916,NA,1912,4,0.20920502092050208
Belgique,BEL,2019,32,1766,NA,1845,-79,-4.281842818428185
Belgique,BEL,2019,33,1777,NA,1856,-79,-4.256465517241379
Belgique,BEL,2019,34,1859,NA,1938,-79,-4.076367389060888
Belgique,BEL,2019,35,2006,NA,1905,101,5.301837270341207
Belgique,BEL,2019,36,1838,NA,1866,-28,-1.5005359056806002
Belgique,BEL,2019,37,1833,NA,1851,-18,-0.9724473257698543
Belgique,BEL,2019,38,1923,NA,1892,31,1.638477801268499
Belgique,BEL,2019,39,1906,NA,1902,4,0.2103049421661409
Belgique,BEL,2019,40,2048,NA,1968,80,4.0650406504065035
Belgique,BEL,2019,41,1951,NA,2020,-69,-3.415841584158416
Belgique,BEL,2019,42,1961,NA,1992,-31,-1.5562248995983934
Belgique,BEL,2019,43,2065,NA,1980,85,4.292929292929292
Belgique,BEL,2019,44,1935,NA,1956,-21,-1.0736196319018405
Belgique,BEL,2019,45,2001,NA,2020,-19,-0.9405940594059405
Belgique,BEL,2019,46,2014,NA,2072,-58,-2.799227799227799
Belgique,BEL,2019,47,2187,NA,2126,61,2.8692380056444025
Belgique,BEL,2019,48,2122,NA,2125,-3,-0.1411764705882353
Belgique,BEL,2019,49,2161,NA,2208,-47,-2.1286231884057973
Belgique,BEL,2019,50,2213,NA,2248,-35,-1.5569395017793595
Belgique,BEL,2019,51,2337,NA,2298,39,1.6971279373368149
Belgique,BEL,2019,52,2152,NA,2293,-141,-6.149149585695595
Belgique,BEL,2020,1,2224,0,2373,-149,-6.278971765697429
Belgique,BEL,2020,2,2380,0,2408,-28,-1.1627906976744187
Belgique,BEL,2020,3,2303,0,2397,-94,-3.9215686274509802
Belgique,BEL,2020,4,2191,0,2400,-209,-8.708333333333334
Belgique,BEL,2020,5,2354,0,2476,-122,-4.92730210016155
Belgique,BEL,2020,6,2161,0,2429,-268,-11.033347056401812
Belgique,BEL,2020,7,2298,0,2432,-134,-5.509868421052631
Belgique,BEL,2020,8,2287,0,2416,-129,-5.339403973509934
Belgique,BEL,2020,9,2231,0,2520,-289,-11.468253968253968
Belgique,BEL,2020,10,2202,0,2452,-250,-10.195758564437195
Belgique,BEL,2020,11,2216,5,2336,-120,-5.136986301369863
Belgique,BEL,2020,12,2544,83,2308,236,10.22530329289428
Belgique,BEL,2020,13,3175,425,2216,959,43.27617328519855
Belgique,BEL,2020,14,4016,1119,2109,1907,90.42200094831674
Belgique,BEL,2020,15,4273,2271,2064,2209,107.0251937984496
Belgique,BEL,2020,16,3692,1925,2026,1666,82.23099703849951
Belgique,BEL,2020,17,3017,1379,2018,999,49.50445986124876
Belgique,BEL,2020,18,2399,717,2014,385,19.116186693147963
Belgique,BEL,2020,19,2367,783,2022,345,17.062314540059347
Belgique,BEL,2020,20,1984,373,1982,2,0.10090817356205853
Bulgarie,BGR,2016,1,2445,NA,2605,-160,-6.142034548944338
Bulgarie,BGR,2016,2,2281,NA,2590,-309,-11.93050193050193
Bulgarie,BGR,2016,3,2276,NA,2555,-279,-10.91976516634051
Bulgarie,BGR,2016,4,2367,NA,2550,-183,-7.1764705882352935
Bulgarie,BGR,2016,5,2304,NA,2492,-188,-7.54414125200642
Bulgarie,BGR,2016,6,2225,NA,2318,-93,-4.012079378774805
Bulgarie,BGR,2016,7,2100,NA,2283,-183,-8.015768725361367
Bulgarie,BGR,2016,8,2095,NA,2226,-131,-5.884995507637017
Bulgarie,BGR,2016,9,1959,NA,2211,-252,-11.397557666214382
Bulgarie,BGR,2016,10,2088,NA,2216,-128,-5.776173285198556
Bulgarie,BGR,2016,11,2100,NA,2145,-45,-2.097902097902098
Bulgarie,BGR,2016,12,2020,NA,2112,-92,-4.356060606060606
Bulgarie,BGR,2016,13,2106,NA,2086,20,0.9587727708533078
Bulgarie,BGR,2016,14,2123,NA,2098,25,1.1916110581506196
Bulgarie,BGR,2016,15,1927,NA,2026,-99,-4.886475814412636
Bulgarie,BGR,2016,16,1945,NA,2022,-77,-3.80811078140455
Bulgarie,BGR,2016,17,1964,NA,2032,-68,-3.346456692913386
Bulgarie,BGR,2016,18,2036,NA,1976,60,3.0364372469635628
Bulgarie,BGR,2016,19,2044,NA,2008,36,1.7928286852589643
Bulgarie,BGR,2016,20,1989,NA,1966,23,1.1698880976602237
Bulgarie,BGR,2016,21,2006,NA,1970,36,1.8274111675126905
Bulgarie,BGR,2016,22,1991,NA,1982,9,0.45408678102926336
Bulgarie,BGR,2016,23,1784,NA,1906,-122,-6.400839454354669
Bulgarie,BGR,2016,24,2012,NA,1923,89,4.6281851274050965
Bulgarie,BGR,2016,25,2145,NA,1976,169,8.552631578947368
Bulgarie,BGR,2016,26,1958,NA,1988,-30,-1.5090543259557343
Bulgarie,BGR,2016,27,1806,NA,1917,-111,-5.790297339593114
Bulgarie,BGR,2016,28,1970,NA,1918,52,2.7111574556830034
Bulgarie,BGR,2016,29,1824,NA,1865,-41,-2.1983914209115283
Bulgarie,BGR,2016,30,1906,NA,1940,-34,-1.7525773195876289
Bulgarie,BGR,2016,31,1970,NA,1917,53,2.764736567553469
Bulgarie,BGR,2016,32,1799,NA,1916,-117,-6.106471816283925
Bulgarie,BGR,2016,33,1810,NA,1840,-30,-1.6304347826086956
Bulgarie,BGR,2016,34,1859,NA,1844,15,0.8134490238611713
Bulgarie,BGR,2016,35,1765,NA,1815,-50,-2.7548209366391188
Bulgarie,BGR,2016,36,1757,NA,1774,-17,-0.9582863585118376
Bulgarie,BGR,2016,37,1821,NA,1840,-19,-1.0326086956521738
Bulgarie,BGR,2016,38,1796,NA,1794,2,0.11148272017837235
Bulgarie,BGR,2016,39,1866,NA,1822,44,2.4149286498353457
Bulgarie,BGR,2016,40,2019,NA,1976,43,2.1761133603238867
Bulgarie,BGR,2016,41,2113,NA,2000,113,5.65
Bulgarie,BGR,2016,42,2104,NA,2068,36,1.7408123791102514
Bulgarie,BGR,2016,43,2133,NA,2048,85,4.150390625
Bulgarie,BGR,2016,44,2074,NA,2061,13,0.6307617661329452
Bulgarie,BGR,2016,45,2139,NA,2106,33,1.566951566951567
Bulgarie,BGR,2016,46,2129,NA,2099,30,1.4292520247737017
Bulgarie,BGR,2016,47,2091,NA,2072,19,0.916988416988417
Bulgarie,BGR,2016,48,2151,NA,2121,30,1.4144271570014144
Bulgarie,BGR,2016,49,2300,NA,2191,109,4.974897307165678
Bulgarie,BGR,2016,50,2281,NA,2211,70,3.1659882406151065
Bulgarie,BGR,2016,51,2431,NA,2236,195,8.720930232558139
Bulgarie,BGR,2016,52,2811,NA,2403,408,16.978776529338326
Bulgarie,BGR,2017,1,3169,NA,2605,564,21.65067178502879
Bulgarie,BGR,2017,2,3222,NA,2590,632,24.4015444015444
Bulgarie,BGR,2017,3,2814,NA,2555,259,10.136986301369863
Bulgarie,BGR,2017,4,2627,NA,2550,77,3.019607843137255
Bulgarie,BGR,2017,5,2525,NA,2492,33,1.3242375601926164
Bulgarie,BGR,2017,6,2347,NA,2318,29,1.2510785159620361
Bulgarie,BGR,2017,7,2352,NA,2283,69,3.0223390275952693
Bulgarie,BGR,2017,8,2312,NA,2226,86,3.8634321653189576
Bulgarie,BGR,2017,9,2138,NA,2211,-73,-3.3016734509271823
Bulgarie,BGR,2017,10,2230,NA,2216,14,0.631768953068592
Bulgarie,BGR,2017,11,2117,NA,2145,-28,-1.3053613053613053
Bulgarie,BGR,2017,12,2115,NA,2112,3,0.14204545454545456
Bulgarie,BGR,2017,13,2098,NA,2086,12,0.5752636625119847
Bulgarie,BGR,2017,14,2079,NA,2098,-19,-0.905624404194471
Bulgarie,BGR,2017,15,2025,NA,2026,-1,-0.04935834155972359
Bulgarie,BGR,2017,16,2116,NA,2022,94,4.648862512363996
Bulgarie,BGR,2017,17,2036,NA,2032,4,0.19685039370078738
Bulgarie,BGR,2017,18,1952,NA,1976,-24,-1.214574898785425
Bulgarie,BGR,2017,19,1983,NA,2008,-25,-1.245019920318725
Bulgarie,BGR,2017,20,1977,NA,1966,11,0.5595116988809765
Bulgarie,BGR,2017,21,1981,NA,1970,11,0.5583756345177665
Bulgarie,BGR,2017,22,2055,NA,1982,73,3.6831483350151366
Bulgarie,BGR,2017,23,1958,NA,1906,52,2.728226652675761
Bulgarie,BGR,2017,24,1912,NA,1923,-11,-0.5720228809152366
Bulgarie,BGR,2017,25,1957,NA,1976,-19,-0.9615384615384616
Bulgarie,BGR,2017,26,2291,NA,1988,303,15.241448692152918
Bulgarie,BGR,2017,27,2008,NA,1917,91,4.747000521648409
Bulgarie,BGR,2017,28,1920,NA,1918,2,0.10427528675703858
Bulgarie,BGR,2017,29,1795,NA,1865,-70,-3.753351206434316
Bulgarie,BGR,2017,30,1914,NA,1940,-26,-1.3402061855670102
Bulgarie,BGR,2017,31,1943,NA,1917,26,1.3562858633281167
Bulgarie,BGR,2017,32,2059,NA,1916,143,7.463465553235908
Bulgarie,BGR,2017,33,1769,NA,1840,-71,-3.858695652173913
Bulgarie,BGR,2017,34,1761,NA,1844,-83,-4.5010845986984815
Bulgarie,BGR,2017,35,1804,NA,1815,-11,-0.6060606060606061
Bulgarie,BGR,2017,36,1762,NA,1774,-12,-0.6764374295377678
Bulgarie,BGR,2017,37,1942,NA,1840,102,5.543478260869565
Bulgarie,BGR,2017,38,1702,NA,1794,-92,-5.128205128205128
Bulgarie,BGR,2017,39,1702,NA,1822,-120,-6.586169045005488
Bulgarie,BGR,2017,40,1929,NA,1976,-47,-2.3785425101214575
Bulgarie,BGR,2017,41,1958,NA,2000,-42,-2.1
Bulgarie,BGR,2017,42,2064,NA,2068,-4,-0.19342359767891684
Bulgarie,BGR,2017,43,2054,NA,2048,6,0.29296875
Bulgarie,BGR,2017,44,2061,NA,2061,0,0
Bulgarie,BGR,2017,45,2016,NA,2106,-90,-4.273504273504273
Bulgarie,BGR,2017,46,2105,NA,2099,6,0.28585040495474034
Bulgarie,BGR,2017,47,2072,NA,2072,0,0
Bulgarie,BGR,2017,48,2052,NA,2121,-69,-3.253182461103253
Bulgarie,BGR,2017,49,2015,NA,2191,-176,-8.032861706983113
Bulgarie,BGR,2017,50,2103,NA,2211,-108,-4.884667571234735
Bulgarie,BGR,2017,51,2033,NA,2236,-203,-9.078711985688729
Bulgarie,BGR,2017,52,2253,NA,2403,-150,-6.242197253433209
Bulgarie,BGR,2018,1,2274,NA,2605,-331,-12.7063339731286
Bulgarie,BGR,2018,2,2166,NA,2590,-424,-16.37065637065637
Bulgarie,BGR,2018,3,2374,NA,2555,-181,-7.084148727984345
Bulgarie,BGR,2018,4,2360,NA,2550,-190,-7.450980392156863
Bulgarie,BGR,2018,5,2564,NA,2492,72,2.889245585874799
Bulgarie,BGR,2018,6,2456,NA,2318,138,5.9534081104400345
Bulgarie,BGR,2018,7,2380,NA,2283,97,4.248795444590451
Bulgarie,BGR,2018,8,2234,NA,2226,8,0.3593890386343217
Bulgarie,BGR,2018,9,2471,NA,2211,260,11.759384893713252
Bulgarie,BGR,2018,10,2382,NA,2216,166,7.490974729241877
Bulgarie,BGR,2018,11,2239,NA,2145,94,4.382284382284382
Bulgarie,BGR,2018,12,2164,NA,2112,52,2.462121212121212
Bulgarie,BGR,2018,13,2057,NA,2086,-29,-1.3902205177372962
Bulgarie,BGR,2018,14,2075,NA,2098,-23,-1.09628217349857
Bulgarie,BGR,2018,15,2061,NA,2026,35,1.7275419545903257
Bulgarie,BGR,2018,16,1991,NA,2022,-31,-1.533135509396637
Bulgarie,BGR,2018,17,2076,NA,2032,44,2.1653543307086616
Bulgarie,BGR,2018,18,1934,NA,1976,-42,-2.1255060728744937
Bulgarie,BGR,2018,19,1887,NA,2008,-121,-6.02589641434263
Bulgarie,BGR,2018,20,1920,NA,1966,-46,-2.3397761953204474
Bulgarie,BGR,2018,21,1897,NA,1970,-73,-3.705583756345178
Bulgarie,BGR,2018,22,1917,NA,1982,-65,-3.279515640766902
Bulgarie,BGR,2018,23,1951,NA,1906,45,2.36096537250787
Bulgarie,BGR,2018,24,1774,NA,1923,-149,-7.748309932397296
Bulgarie,BGR,2018,25,1776,NA,1976,-200,-10.121457489878543
Bulgarie,BGR,2018,26,1793,NA,1988,-195,-9.808853118712275
Bulgarie,BGR,2018,27,1900,NA,1917,-17,-0.8868022952529996
Bulgarie,BGR,2018,28,1963,NA,1918,45,2.346193952033368
Bulgarie,BGR,2018,29,1975,NA,1865,110,5.898123324396782
Bulgarie,BGR,2018,30,1976,NA,1940,36,1.8556701030927836
Bulgarie,BGR,2018,31,1902,NA,1917,-15,-0.7824726134585289
Bulgarie,BGR,2018,32,1911,NA,1916,-5,-0.2609603340292276
Bulgarie,BGR,2018,33,1860,NA,1840,20,1.0869565217391304
Bulgarie,BGR,2018,34,1822,NA,1844,-22,-1.193058568329718
Bulgarie,BGR,2018,35,1828,NA,1815,13,0.7162534435261708
Bulgarie,BGR,2018,36,1842,NA,1774,68,3.8331454340473505
Bulgarie,BGR,2018,37,1845,NA,1840,5,0.2717391304347826
Bulgarie,BGR,2018,38,1885,NA,1794,91,5.072463768115942
Bulgarie,BGR,2018,39,1892,NA,1822,70,3.841931942919868
Bulgarie,BGR,2018,40,2068,NA,1976,92,4.65587044534413
Bulgarie,BGR,2018,41,2040,NA,2000,40,2
Bulgarie,BGR,2018,42,2132,NA,2068,64,3.0947775628626695
Bulgarie,BGR,2018,43,2092,NA,2048,44,2.1484375
Bulgarie,BGR,2018,44,2069,NA,2061,8,0.38816108685104317
Bulgarie,BGR,2018,45,2073,NA,2106,-33,-1.566951566951567
Bulgarie,BGR,2018,46,2135,NA,2099,36,1.715102429728442
Bulgarie,BGR,2018,47,2166,NA,2072,94,4.536679536679537
Bulgarie,BGR,2018,48,2209,NA,2121,88,4.148986327204149
Bulgarie,BGR,2018,49,2322,NA,2191,131,5.979005020538567
Bulgarie,BGR,2018,50,2346,NA,2211,135,6.1058344640434195
Bulgarie,BGR,2018,51,2345,NA,2236,109,4.874776386404293
Bulgarie,BGR,2018,52,2431,NA,2403,28,1.1652101539741988
Bulgarie,BGR,2019,1,2533,NA,2605,-72,-2.763915547024952
Bulgarie,BGR,2019,2,2692,NA,2590,102,3.9382239382239383
Bulgarie,BGR,2019,3,2756,NA,2555,201,7.8669275929549904
Bulgarie,BGR,2019,4,2848,NA,2550,298,11.686274509803923
Bulgarie,BGR,2019,5,2573,NA,2492,81,3.250401284109149
Bulgarie,BGR,2019,6,2245,NA,2318,-73,-3.1492666091458155
Bulgarie,BGR,2019,7,2300,NA,2283,17,0.7446342531756461
Bulgarie,BGR,2019,8,2264,NA,2226,38,1.7070979335130279
Bulgarie,BGR,2019,9,2275,NA,2211,64,2.8946178199909545
Bulgarie,BGR,2019,10,2166,NA,2216,-50,-2.256317689530686
Bulgarie,BGR,2019,11,2123,NA,2145,-22,-1.0256410256410255
Bulgarie,BGR,2019,12,2148,NA,2112,36,1.7045454545454544
Bulgarie,BGR,2019,13,2081,NA,2086,-5,-0.23969319271332695
Bulgarie,BGR,2019,14,2114,NA,2098,16,0.7626310772163966
Bulgarie,BGR,2019,15,2092,NA,2026,66,3.257650542941757
Bulgarie,BGR,2019,16,2036,NA,2022,14,0.6923837784371909
Bulgarie,BGR,2019,17,2051,NA,2032,19,0.9350393700787403
Bulgarie,BGR,2019,18,1980,NA,1976,4,0.20242914979757085
Bulgarie,BGR,2019,19,2120,NA,2008,112,5.577689243027888
Bulgarie,BGR,2019,20,1980,NA,1966,14,0.7121057985757884
Bulgarie,BGR,2019,21,1998,NA,1970,28,1.4213197969543148
Bulgarie,BGR,2019,22,1967,NA,1982,-15,-0.756811301715439
Bulgarie,BGR,2019,23,1932,NA,1906,26,1.3641133263378804
Bulgarie,BGR,2019,24,1994,NA,1923,71,3.692147685907436
Bulgarie,BGR,2019,25,2026,NA,1976,50,2.5303643724696356
Bulgarie,BGR,2019,26,1908,NA,1988,-80,-4.0241448692152915
Bulgarie,BGR,2019,27,1954,NA,1917,37,1.9300991131977048
Bulgarie,BGR,2019,28,1820,NA,1918,-98,-5.109489051094891
Bulgarie,BGR,2019,29,1867,NA,1865,2,0.10723860589812334
Bulgarie,BGR,2019,30,1963,NA,1940,23,1.1855670103092784
Bulgarie,BGR,2019,31,1854,NA,1917,-63,-3.286384976525822
Bulgarie,BGR,2019,32,1896,NA,1916,-20,-1.0438413361169103
Bulgarie,BGR,2019,33,1920,NA,1840,80,4.3478260869565215
Bulgarie,BGR,2019,34,1936,NA,1844,92,4.989154013015185
Bulgarie,BGR,2019,35,1863,NA,1815,48,2.644628099173554
Bulgarie,BGR,2019,36,1734,NA,1774,-40,-2.254791431792559
Bulgarie,BGR,2019,37,1753,NA,1840,-87,-4.728260869565217
Bulgarie,BGR,2019,38,1791,NA,1794,-3,-0.16722408026755853
Bulgarie,BGR,2019,39,1827,NA,1822,5,0.27442371020856204
Bulgarie,BGR,2019,40,1887,NA,1976,-89,-4.504048582995952
Bulgarie,BGR,2019,41,1888,NA,2000,-112,-5.6000000000000005
Bulgarie,BGR,2019,42,1971,NA,2068,-97,-4.690522243713733
Bulgarie,BGR,2019,43,1911,NA,2048,-137,-6.689453125
Bulgarie,BGR,2019,44,2039,NA,2061,-22,-1.067442988840369
Bulgarie,BGR,2019,45,2194,NA,2106,88,4.178537511870846
Bulgarie,BGR,2019,46,2026,NA,2099,-73,-3.4778465936160075
Bulgarie,BGR,2019,47,1958,NA,2072,-114,-5.501930501930502
Bulgarie,BGR,2019,48,2071,NA,2121,-50,-2.3573785950023574
Bulgarie,BGR,2019,49,2128,NA,2191,-63,-2.8753993610223643
Bulgarie,BGR,2019,50,2113,NA,2211,-98,-4.432383536861149
Bulgarie,BGR,2019,51,2135,NA,2236,-101,-4.516994633273703
Bulgarie,BGR,2019,52,2117,NA,2403,-286,-11.901789429879317
Bulgarie,BGR,2020,1,2093,NA,2605,-512,-19.654510556621883
Bulgarie,BGR,2020,2,2265,NA,2590,-325,-12.548262548262548
Bulgarie,BGR,2020,3,2169,NA,2555,-386,-15.107632093933464
Bulgarie,BGR,2020,4,2382,NA,2550,-168,-6.588235294117648
Bulgarie,BGR,2020,5,2417,NA,2492,-75,-3.009630818619583
Bulgarie,BGR,2020,6,2330,NA,2318,12,0.5176876617773942
Bulgarie,BGR,2020,7,2292,NA,2283,9,0.39421813403416556
Bulgarie,BGR,2020,8,2147,NA,2226,-79,-3.5489667565139262
Bulgarie,BGR,2020,9,2159,NA,2211,-52,-2.3518769787426503
Bulgarie,BGR,2020,10,2026,0,2216,-190,-8.574007220216606
Bulgarie,BGR,2020,11,2053,2,2145,-92,-4.2890442890442895
Bulgarie,BGR,2020,12,2017,1,2112,-95,-4.4981060606060606
Bulgarie,BGR,2020,13,2044,5,2086,-42,-2.013422818791946
Bulgarie,BGR,2020,14,2005,14,2098,-93,-4.4327931363203055
Bulgarie,BGR,2020,15,1993,10,2026,-33,-1.6288252714708784
Bulgarie,BGR,2020,16,1989,11,2022,-33,-1.6320474777448073
Bulgarie,BGR,2020,17,1949,15,2032,-83,-4.084645669291338
Bulgarie,BGR,2020,18,1864,20,1976,-112,-5.668016194331984
Bulgarie,BGR,2020,19,1883,15,2008,-125,-6.225099601593626
Bulgarie,BGR,2020,20,2054,19,1966,88,4.476093591047812
Bulgarie,BGR,2020,21,1851,18,1970,-119,-6.040609137055838
Bulgarie,BGR,2020,22,1762,14,1982,-220,-11.099899091826437
Suisse,CHE,2016,1,1340,NA,1480,-140,-9.45945945945946
Suisse,CHE,2016,2,1243,NA,1476,-233,-15.785907859078591
Suisse,CHE,2016,3,1323,NA,1480,-157,-10.608108108108109
Suisse,CHE,2016,4,1351,NA,1452,-101,-6.955922865013774
Suisse,CHE,2016,5,1345,NA,1436,-91,-6.337047353760446
Suisse,CHE,2016,6,1340,NA,1464,-124,-8.469945355191257
Suisse,CHE,2016,7,1313,NA,1432,-119,-8.310055865921788
Suisse,CHE,2016,8,1380,NA,1442,-62,-4.2995839112343965
Suisse,CHE,2016,9,1320,NA,1470,-150,-10.204081632653061
Suisse,CHE,2016,10,1355,NA,1422,-67,-4.7116736990154715
Suisse,CHE,2016,11,1278,NA,1350,-72,-5.333333333333334
Suisse,CHE,2016,12,1294,NA,1316,-22,-1.6717325227963524
Suisse,CHE,2016,13,1269,NA,1280,-11,-0.8593750000000001
Suisse,CHE,2016,14,1242,NA,1299,-57,-4.387990762124711
Suisse,CHE,2016,15,1224,NA,1237,-13,-1.0509296685529508
Suisse,CHE,2016,16,1139,NA,1214,-75,-6.177924217462932
Suisse,CHE,2016,17,1175,NA,1194,-19,-1.5912897822445562
Suisse,CHE,2016,18,1172,NA,1216,-44,-3.618421052631579
Suisse,CHE,2016,19,1149,NA,1205,-56,-4.647302904564316
Suisse,CHE,2016,20,1176,NA,1180,-4,-0.3389830508474576
Suisse,CHE,2016,21,1227,NA,1227,0,0
Suisse,CHE,2016,22,1150,NA,1170,-20,-1.7094017094017095
Suisse,CHE,2016,23,1104,NA,1160,-56,-4.827586206896552
Suisse,CHE,2016,24,1113,NA,1131,-18,-1.5915119363395225
Suisse,CHE,2016,25,1237,NA,1192,45,3.7751677852348995
Suisse,CHE,2016,26,1172,NA,1190,-18,-1.5126050420168067
Suisse,CHE,2016,27,1092,NA,1165,-73,-6.266094420600858
Suisse,CHE,2016,28,1164,NA,1138,26,2.2847100175746924
Suisse,CHE,2016,29,1235,NA,1204,31,2.574750830564784
Suisse,CHE,2016,30,1181,NA,1196,-15,-1.254180602006689
Suisse,CHE,2016,31,1113,NA,1179,-66,-5.597964376590331
Suisse,CHE,2016,32,1150,NA,1152,-2,-0.1736111111111111
Suisse,CHE,2016,33,1166,NA,1156,10,0.8650519031141869
Suisse,CHE,2016,34,1131,NA,1184,-53,-4.476351351351352
Suisse,CHE,2016,35,1137,NA,1164,-27,-2.3195876288659796
Suisse,CHE,2016,36,1184,NA,1172,12,1.023890784982935
Suisse,CHE,2016,37,1103,NA,1194,-91,-7.6214405360134005
Suisse,CHE,2016,38,1180,NA,1230,-50,-4.0650406504065035
Suisse,CHE,2016,39,1212,NA,1226,-14,-1.1419249592169658
Suisse,CHE,2016,40,1286,NA,1260,26,2.0634920634920633
Suisse,CHE,2016,41,1271,NA,1262,9,0.7131537242472267
Suisse,CHE,2016,42,1277,NA,1249,28,2.241793434747798
Suisse,CHE,2016,43,1230,NA,1246,-16,-1.2841091492776886
Suisse,CHE,2016,44,1313,NA,1240,73,5.887096774193548
Suisse,CHE,2016,45,1286,NA,1281,5,0.39032006245121
Suisse,CHE,2016,46,1353,NA,1304,49,3.7576687116564416
Suisse,CHE,2016,47,1193,NA,1280,-87,-6.796874999999999
Suisse,CHE,2016,48,1331,NA,1356,-25,-1.8436578171091444
Suisse,CHE,2016,49,1294,NA,1323,-29,-2.1919879062736203
Suisse,CHE,2016,50,1301,NA,1345,-44,-3.2713754646840147
Suisse,CHE,2016,51,1446,NA,1406,40,2.844950213371266
Suisse,CHE,2016,52,1589,NA,1410,179,12.695035460992907
Suisse,CHE,2017,1,1678,NA,1480,198,13.378378378378377
Suisse,CHE,2017,2,1731,NA,1476,255,17.276422764227643
Suisse,CHE,2017,3,1746,NA,1480,266,17.972972972972972
Suisse,CHE,2017,4,1657,NA,1452,205,14.118457300275484
Suisse,CHE,2017,5,1564,NA,1436,128,8.913649025069638
Suisse,CHE,2017,6,1592,NA,1464,128,8.743169398907105
Suisse,CHE,2017,7,1402,NA,1432,-30,-2.094972067039106
Suisse,CHE,2017,8,1383,NA,1442,-59,-4.091539528432732
Suisse,CHE,2017,9,1395,NA,1470,-75,-5.1020408163265305
Suisse,CHE,2017,10,1348,NA,1422,-74,-5.20393811533052
Suisse,CHE,2017,11,1262,NA,1350,-88,-6.518518518518518
Suisse,CHE,2017,12,1239,NA,1316,-77,-5.851063829787234
Suisse,CHE,2017,13,1183,NA,1280,-97,-7.578124999999999
Suisse,CHE,2017,14,1234,NA,1299,-65,-5.003849114703618
Suisse,CHE,2017,15,1201,NA,1237,-36,-2.9102667744543247
Suisse,CHE,2017,16,1181,NA,1214,-33,-2.7182866556836904
Suisse,CHE,2017,17,1223,NA,1194,29,2.4288107202680065
Suisse,CHE,2017,18,1210,NA,1216,-6,-0.4934210526315789
Suisse,CHE,2017,19,1204,NA,1205,-1,-0.08298755186721991
Suisse,CHE,2017,20,1207,NA,1180,27,2.288135593220339
Suisse,CHE,2017,21,1186,NA,1227,-41,-3.341483292583537
Suisse,CHE,2017,22,1126,NA,1170,-44,-3.7606837606837606
Suisse,CHE,2017,23,1108,NA,1160,-52,-4.482758620689655
Suisse,CHE,2017,24,1120,NA,1131,-11,-0.9725906277630416
Suisse,CHE,2017,25,1196,NA,1192,4,0.33557046979865773
Suisse,CHE,2017,26,1166,NA,1190,-24,-2.0168067226890756
Suisse,CHE,2017,27,1158,NA,1165,-7,-0.6008583690987125
Suisse,CHE,2017,28,1087,NA,1138,-51,-4.481546572934974
Suisse,CHE,2017,29,1151,NA,1204,-53,-4.401993355481728
Suisse,CHE,2017,30,1121,NA,1196,-75,-6.270903010033445
Suisse,CHE,2017,31,1200,NA,1179,21,1.7811704834605597
Suisse,CHE,2017,32,1099,NA,1152,-53,-4.600694444444445
Suisse,CHE,2017,33,1128,NA,1156,-28,-2.422145328719723
Suisse,CHE,2017,34,1207,NA,1184,23,1.9425675675675675
Suisse,CHE,2017,35,1164,NA,1164,0,0
Suisse,CHE,2017,36,1153,NA,1172,-19,-1.621160409556314
Suisse,CHE,2017,37,1190,NA,1194,-4,-0.33500837520938026
Suisse,CHE,2017,38,1265,NA,1230,35,2.8455284552845526
Suisse,CHE,2017,39,1243,NA,1226,17,1.3866231647634584
Suisse,CHE,2017,40,1295,NA,1260,35,2.7777777777777777
Suisse,CHE,2017,41,1268,NA,1262,6,0.4754358161648178
Suisse,CHE,2017,42,1210,NA,1249,-39,-3.122497998398719
Suisse,CHE,2017,43,1214,NA,1246,-32,-2.568218298555377
Suisse,CHE,2017,44,1153,NA,1240,-87,-7.016129032258064
Suisse,CHE,2017,45,1312,NA,1281,31,2.419984387197502
Suisse,CHE,2017,46,1251,NA,1304,-53,-4.064417177914111
Suisse,CHE,2017,47,1318,NA,1280,38,2.96875
Suisse,CHE,2017,48,1396,NA,1356,40,2.949852507374631
Suisse,CHE,2017,49,1390,NA,1323,67,5.064247921390779
Suisse,CHE,2017,50,1357,NA,1345,12,0.8921933085501859
Suisse,CHE,2017,51,1456,NA,1406,50,3.556187766714083
Suisse,CHE,2017,52,1375,NA,1410,-35,-2.4822695035460995
Suisse,CHE,2018,1,1561,NA,1480,81,5.472972972972974
Suisse,CHE,2018,2,1541,NA,1476,65,4.403794037940379
Suisse,CHE,2018,3,1494,NA,1480,14,0.945945945945946
Suisse,CHE,2018,4,1397,NA,1452,-55,-3.787878787878788
Suisse,CHE,2018,5,1397,NA,1436,-39,-2.715877437325905
Suisse,CHE,2018,6,1441,NA,1464,-23,-1.5710382513661203
Suisse,CHE,2018,7,1458,NA,1432,26,1.8156424581005588
Suisse,CHE,2018,8,1478,NA,1442,36,2.496532593619972
Suisse,CHE,2018,9,1636,NA,1470,166,11.292517006802722
Suisse,CHE,2018,10,1532,NA,1422,110,7.7355836849507735
Suisse,CHE,2018,11,1482,NA,1350,132,9.777777777777779
Suisse,CHE,2018,12,1380,NA,1316,64,4.86322188449848
Suisse,CHE,2018,13,1348,NA,1280,68,5.3125
Suisse,CHE,2018,14,1339,NA,1299,40,3.079291762894534
Suisse,CHE,2018,15,1300,NA,1237,63,5.092966855295069
Suisse,CHE,2018,16,1229,NA,1214,15,1.2355848434925865
Suisse,CHE,2018,17,1147,NA,1194,-47,-3.936348408710218
Suisse,CHE,2018,18,1226,NA,1216,10,0.8223684210526315
Suisse,CHE,2018,19,1200,NA,1205,-5,-0.4149377593360996
Suisse,CHE,2018,20,1117,NA,1180,-63,-5.338983050847458
Suisse,CHE,2018,21,1223,NA,1227,-4,-0.32599837000814996
Suisse,CHE,2018,22,1159,NA,1170,-11,-0.9401709401709402
Suisse,CHE,2018,23,1178,NA,1160,18,1.5517241379310345
Suisse,CHE,2018,24,1119,NA,1131,-12,-1.0610079575596816
Suisse,CHE,2018,25,1127,NA,1192,-65,-5.453020134228188
Suisse,CHE,2018,26,1181,NA,1190,-9,-0.7563025210084033
Suisse,CHE,2018,27,1152,NA,1165,-13,-1.1158798283261802
Suisse,CHE,2018,28,1078,NA,1138,-60,-5.272407732864675
Suisse,CHE,2018,29,1223,NA,1204,19,1.5780730897009967
Suisse,CHE,2018,30,1222,NA,1196,26,2.1739130434782608
Suisse,CHE,2018,31,1264,NA,1179,85,7.20949957591179
Suisse,CHE,2018,32,1222,NA,1152,70,6.076388888888888
Suisse,CHE,2018,33,1187,NA,1156,31,2.6816608996539792
Suisse,CHE,2018,34,1145,NA,1184,-39,-3.2939189189189184
Suisse,CHE,2018,35,1206,NA,1164,42,3.608247422680412
Suisse,CHE,2018,36,1178,NA,1172,6,0.5119453924914675
Suisse,CHE,2018,37,1230,NA,1194,36,3.015075376884422
Suisse,CHE,2018,38,1177,NA,1230,-53,-4.308943089430894
Suisse,CHE,2018,39,1212,NA,1226,-14,-1.1419249592169658
Suisse,CHE,2018,40,1225,NA,1260,-35,-2.7777777777777777
Suisse,CHE,2018,41,1233,NA,1262,-29,-2.2979397781299524
Suisse,CHE,2018,42,1211,NA,1249,-38,-3.042433947157726
Suisse,CHE,2018,43,1233,NA,1246,-13,-1.043338683788122
Suisse,CHE,2018,44,1272,NA,1240,32,2.5806451612903225
Suisse,CHE,2018,45,1263,NA,1281,-18,-1.405152224824356
Suisse,CHE,2018,46,1248,NA,1304,-56,-4.294478527607362
Suisse,CHE,2018,47,1280,NA,1280,0,0
Suisse,CHE,2018,48,1321,NA,1356,-35,-2.5811209439528024
Suisse,CHE,2018,49,1389,NA,1323,66,4.988662131519274
Suisse,CHE,2018,50,1356,NA,1345,11,0.8178438661710037
Suisse,CHE,2018,51,1322,NA,1406,-84,-5.974395448079658
Suisse,CHE,2018,52,1349,NA,1410,-61,-4.326241134751773
Suisse,CHE,2019,1,1341,NA,1480,-139,-9.391891891891891
Suisse,CHE,2019,2,1389,NA,1476,-87,-5.894308943089431
Suisse,CHE,2019,3,1358,NA,1480,-122,-8.243243243243244
Suisse,CHE,2019,4,1403,NA,1452,-49,-3.3746556473829203
Suisse,CHE,2019,5,1439,NA,1436,3,0.20891364902506965
Suisse,CHE,2019,6,1481,NA,1464,17,1.1612021857923498
Suisse,CHE,2019,7,1555,NA,1432,123,8.589385474860336
Suisse,CHE,2019,8,1527,NA,1442,85,5.894590846047157
Suisse,CHE,2019,9,1527,NA,1470,57,3.877551020408163
Suisse,CHE,2019,10,1452,NA,1422,30,2.109704641350211
Suisse,CHE,2019,11,1379,NA,1350,29,2.148148148148148
Suisse,CHE,2019,12,1351,NA,1316,35,2.6595744680851063
Suisse,CHE,2019,13,1322,NA,1280,42,3.28125
Suisse,CHE,2019,14,1382,NA,1299,83,6.389530408006158
Suisse,CHE,2019,15,1222,NA,1237,-15,-1.2126111560226354
Suisse,CHE,2019,16,1308,NA,1214,94,7.742998352553541
Suisse,CHE,2019,17,1233,NA,1194,39,3.2663316582914574
Suisse,CHE,2019,18,1256,NA,1216,40,3.289473684210526
Suisse,CHE,2019,19,1266,NA,1205,61,5.062240663900415
Suisse,CHE,2019,20,1218,NA,1180,38,3.2203389830508473
Suisse,CHE,2019,21,1271,NA,1227,44,3.585982070089649
Suisse,CHE,2019,22,1245,NA,1170,75,6.41025641025641
Suisse,CHE,2019,23,1251,NA,1160,91,7.844827586206897
Suisse,CHE,2019,24,1171,NA,1131,40,3.5366931918656057
Suisse,CHE,2019,25,1210,NA,1192,18,1.5100671140939599
Suisse,CHE,2019,26,1243,NA,1190,53,4.453781512605042
Suisse,CHE,2019,27,1258,NA,1165,93,7.982832618025751
Suisse,CHE,2019,28,1225,NA,1138,87,7.644991212653779
Suisse,CHE,2019,29,1206,NA,1204,2,0.16611295681063123
Suisse,CHE,2019,30,1260,NA,1196,64,5.351170568561873
Suisse,CHE,2019,31,1139,NA,1179,-40,-3.3927056827820183
Suisse,CHE,2019,32,1138,NA,1152,-14,-1.215277777777778
Suisse,CHE,2019,33,1142,NA,1156,-14,-1.2110726643598615
Suisse,CHE,2019,34,1252,NA,1184,68,5.743243243243244
Suisse,CHE,2019,35,1147,NA,1164,-17,-1.4604810996563573
Suisse,CHE,2019,36,1172,NA,1172,0,0
Suisse,CHE,2019,37,1252,NA,1194,58,4.857621440536013
Suisse,CHE,2019,38,1296,NA,1230,66,5.365853658536586
Suisse,CHE,2019,39,1237,NA,1226,11,0.897226753670473
Suisse,CHE,2019,40,1234,NA,1260,-26,-2.0634920634920633
Suisse,CHE,2019,41,1278,NA,1262,16,1.2678288431061806
Suisse,CHE,2019,42,1298,NA,1249,49,3.923138510808647
Suisse,CHE,2019,43,1307,NA,1246,61,4.895666131621187
Suisse,CHE,2019,44,1224,NA,1240,-16,-1.2903225806451613
Suisse,CHE,2019,45,1264,NA,1281,-17,-1.3270882123341141
Suisse,CHE,2019,46,1365,NA,1304,61,4.677914110429448
Suisse,CHE,2019,47,1331,NA,1280,51,3.9843749999999996
Suisse,CHE,2019,48,1375,NA,1356,19,1.4011799410029497
Suisse,CHE,2019,49,1218,NA,1323,-105,-7.936507936507936
Suisse,CHE,2019,50,1367,NA,1345,22,1.6356877323420074
Suisse,CHE,2019,51,1401,NA,1406,-5,-0.35561877667140823
Suisse,CHE,2019,52,1329,NA,1410,-81,-5.74468085106383
Suisse,CHE,2020,1,1303,0,1480,-177,-11.95945945945946
Suisse,CHE,2020,2,1354,0,1476,-122,-8.26558265582656
Suisse,CHE,2020,3,1400,0,1480,-80,-5.405405405405405
Suisse,CHE,2020,4,1405,0,1452,-47,-3.236914600550964
Suisse,CHE,2020,5,1415,0,1436,-21,-1.4623955431754874
Suisse,CHE,2020,6,1376,0,1464,-88,-6.0109289617486334
Suisse,CHE,2020,7,1371,0,1432,-61,-4.259776536312849
Suisse,CHE,2020,8,1353,0,1442,-89,-6.171983356449376
Suisse,CHE,2020,9,1329,0,1470,-141,-9.591836734693878
Suisse,CHE,2020,10,1338,2,1422,-84,-5.9071729957805905
Suisse,CHE,2020,11,1376,12,1350,26,1.925925925925926
Suisse,CHE,2020,12,1511,52,1316,195,14.817629179331307
Suisse,CHE,2020,13,1595,229,1280,315,24.609375
Suisse,CHE,2020,14,1839,289,1299,540,41.570438799076214
Suisse,CHE,2020,15,1606,274,1237,369,29.830234438156833
Suisse,CHE,2020,16,1536,283,1214,322,26.523887973640857
Suisse,CHE,2020,17,1338,211,1194,144,12.060301507537687
Suisse,CHE,2020,18,1210,124,1216,-6,-0.4934210526315789
Suisse,CHE,2020,19,1137,66,1205,-68,-5.643153526970955
Suisse,CHE,2020,20,1090,60,1180,-90,-7.627118644067797
Suisse,CHE,2020,21,1113,39,1227,-114,-9.290953545232274
Suisse,CHE,2020,22,941,15,1170,-229,-19.572649572649574
République tchèque,CZE,2016,1,2222,NA,2362,-140,-5.927180355630822
République tchèque,CZE,2016,2,2054,NA,2320,-266,-11.46551724137931
République tchèque,CZE,2016,3,2175,NA,2387,-212,-8.881441139505656
République tchèque,CZE,2016,4,2116,NA,2358,-242,-10.262934690415607
République tchèque,CZE,2016,5,2137,NA,2362,-225,-9.525825571549534
République tchèque,CZE,2016,6,2245,NA,2434,-189,-7.764995891536565
République tchèque,CZE,2016,7,2160,NA,2441,-281,-11.511675542810323
République tchèque,CZE,2016,8,2214,NA,2455,-241,-9.816700610997964
République tchèque,CZE,2016,9,2235,NA,2430,-195,-8.024691358024691
République tchèque,CZE,2016,10,2096,NA,2424,-328,-13.531353135313532
République tchèque,CZE,2016,11,2155,NA,2341,-186,-7.945322511747116
République tchèque,CZE,2016,12,2148,NA,2264,-116,-5.123674911660777
République tchèque,CZE,2016,13,2191,NA,2193,-2,-0.09119927040583675
République tchèque,CZE,2016,14,2138,NA,2150,-12,-0.5581395348837209
République tchèque,CZE,2016,15,2075,NA,2118,-43,-2.0302171860245513
République tchèque,CZE,2016,16,1949,NA,2037,-88,-4.32007854688267
République tchèque,CZE,2016,17,2114,NA,2090,24,1.1483253588516746
République tchèque,CZE,2016,18,1982,NA,2024,-42,-2.075098814229249
République tchèque,CZE,2016,19,2001,NA,2032,-31,-1.5255905511811023
République tchèque,CZE,2016,20,1964,NA,1981,-17,-0.8581524482584554
République tchèque,CZE,2016,21,2000,NA,1985,15,0.7556675062972292
République tchèque,CZE,2016,22,2042,NA,2041,1,0.04899559039686428
République tchèque,CZE,2016,23,1893,NA,1947,-54,-2.773497688751926
République tchèque,CZE,2016,24,1915,NA,1975,-60,-3.0379746835443036
République tchèque,CZE,2016,25,1993,NA,1995,-2,-0.10025062656641603
République tchèque,CZE,2016,26,1970,NA,1979,-9,-0.4547751389590703
République tchèque,CZE,2016,27,1886,NA,1966,-80,-4.069175991861648
République tchèque,CZE,2016,28,1918,NA,1950,-32,-1.641025641025641
République tchèque,CZE,2016,29,1981,NA,2006,-25,-1.2462612163509472
République tchèque,CZE,2016,30,1942,NA,2009,-67,-3.3349925335988053
République tchèque,CZE,2016,31,1827,NA,2073,-246,-11.866859623733719
République tchèque,CZE,2016,32,1839,NA,1986,-147,-7.401812688821751
République tchèque,CZE,2016,33,1949,NA,1940,9,0.4639175257731959
République tchèque,CZE,2016,34,2043,NA,1999,44,2.2011005502751377
République tchèque,CZE,2016,35,1918,NA,1955,-37,-1.8925831202046037
République tchèque,CZE,2016,36,1980,NA,1950,30,1.5384615384615385
République tchèque,CZE,2016,37,1930,NA,1970,-40,-2.030456852791878
République tchèque,CZE,2016,38,1834,NA,1994,-160,-8.02407221664995
République tchèque,CZE,2016,39,1988,NA,2044,-56,-2.73972602739726
République tchèque,CZE,2016,40,1991,NA,2126,-135,-6.349952963311383
République tchèque,CZE,2016,41,2083,NA,2128,-45,-2.1146616541353382
République tchèque,CZE,2016,42,2142,NA,2071,71,3.4282955094157415
République tchèque,CZE,2016,43,2035,NA,2075,-40,-1.9277108433734942
République tchèque,CZE,2016,44,1997,NA,2066,-69,-3.339787028073572
République tchèque,CZE,2016,45,1968,NA,2041,-73,-3.576678098971093
République tchèque,CZE,2016,46,2134,NA,2103,31,1.4740846409890631
République tchèque,CZE,2016,47,2084,NA,2117,-33,-1.5588096362777515
République tchèque,CZE,2016,48,2125,NA,2118,7,0.3305004721435316
République tchèque,CZE,2016,49,2200,NA,2144,56,2.6119402985074625
République tchèque,CZE,2016,50,2204,NA,2188,16,0.7312614259597806
République tchèque,CZE,2016,51,2435,NA,2276,159,6.985940246045693
République tchèque,CZE,2016,52,2620,NA,2303,317,13.764654798089449
République tchèque,CZE,2017,1,2763,NA,2362,401,16.97713801862828
République tchèque,CZE,2017,2,2811,NA,2320,491,21.163793103448274
République tchèque,CZE,2017,3,2833,NA,2387,446,18.68454126518643
République tchèque,CZE,2017,4,2761,NA,2358,403,17.09075487701442
République tchèque,CZE,2017,5,2598,NA,2362,236,9.991532599491956
République tchèque,CZE,2017,6,2640,NA,2434,206,8.4634346754313885
République tchèque,CZE,2017,7,2492,NA,2441,51,2.0893076607947565
République tchèque,CZE,2017,8,2357,NA,2455,-98,-3.9918533604887987
République tchèque,CZE,2017,9,2353,NA,2430,-77,-3.168724279835391
République tchèque,CZE,2017,10,2225,NA,2424,-199,-8.209570957095709
République tchèque,CZE,2017,11,2164,NA,2341,-177,-7.56087142246903
République tchèque,CZE,2017,12,2103,NA,2264,-161,-7.1113074204947
République tchèque,CZE,2017,13,2075,NA,2193,-118,-5.380756953944369
République tchèque,CZE,2017,14,2069,NA,2150,-81,-3.7674418604651163
République tchèque,CZE,2017,15,1994,NA,2118,-124,-5.854579792256846
République tchèque,CZE,2017,16,2043,NA,2037,6,0.29455081001472755
République tchèque,CZE,2017,17,2051,NA,2090,-39,-1.8660287081339715
République tchèque,CZE,2017,18,2041,NA,2024,17,0.8399209486166008
République tchèque,CZE,2017,19,2074,NA,2032,42,2.066929133858268
République tchèque,CZE,2017,20,1974,NA,1981,-7,-0.35335689045936397
République tchèque,CZE,2017,21,1932,NA,1985,-53,-2.6700251889168762
République tchèque,CZE,2017,22,2033,NA,2041,-8,-0.39196472317491426
République tchèque,CZE,2017,23,1836,NA,1947,-111,-5.701078582434515
République tchèque,CZE,2017,24,1978,NA,1975,3,0.1518987341772152
République tchèque,CZE,2017,25,2042,NA,1995,47,2.355889724310777
République tchèque,CZE,2017,26,1939,NA,1979,-40,-2.02122283981809
République tchèque,CZE,2017,27,1953,NA,1966,-13,-0.6612410986775178
République tchèque,CZE,2017,28,1886,NA,1950,-64,-3.282051282051282
République tchèque,CZE,2017,29,1972,NA,2006,-34,-1.694915254237288
République tchèque,CZE,2017,30,1770,NA,2009,-239,-11.896465903434544
République tchèque,CZE,2017,31,2077,NA,2073,4,0.1929570670525808
République tchèque,CZE,2017,32,1959,NA,1986,-27,-1.3595166163141994
République tchèque,CZE,2017,33,1861,NA,1940,-79,-4.072164948453608
République tchèque,CZE,2017,34,1939,NA,1999,-60,-3.001500750375188
République tchèque,CZE,2017,35,1848,NA,1955,-107,-5.4731457800511505
République tchèque,CZE,2017,36,1920,NA,1950,-30,-1.5384615384615385
République tchèque,CZE,2017,37,1991,NA,1970,21,1.065989847715736
République tchèque,CZE,2017,38,2058,NA,1994,64,3.20962888665998
République tchèque,CZE,2017,39,2125,NA,2044,81,3.962818003913894
République tchèque,CZE,2017,40,2235,NA,2126,109,5.126999059266227
République tchèque,CZE,2017,41,2156,NA,2128,28,1.3157894736842104
République tchèque,CZE,2017,42,2029,NA,2071,-42,-2.0280057943022696
République tchèque,CZE,2017,43,2101,NA,2075,26,1.253012048192771
République tchèque,CZE,2017,44,2053,NA,2066,-13,-0.6292352371732818
République tchèque,CZE,2017,45,2040,NA,2041,-1,-0.04899559039686428
République tchèque,CZE,2017,46,2057,NA,2103,-46,-2.187351402757965
République tchèque,CZE,2017,47,2071,NA,2117,-46,-2.172886159659896
République tchèque,CZE,2017,48,2116,NA,2118,-2,-0.09442870632672333
République tchèque,CZE,2017,49,2102,NA,2144,-42,-1.9589552238805972
République tchèque,CZE,2017,50,2187,NA,2188,-1,-0.04570383912248629
République tchèque,CZE,2017,51,2119,NA,2276,-157,-6.8980667838312835
République tchèque,CZE,2017,52,2201,NA,2303,-102,-4.429005644811116
République tchèque,CZE,2018,1,2143,NA,2362,-219,-9.271803556308214
République tchèque,CZE,2018,2,2126,NA,2320,-194,-8.362068965517242
République tchèque,CZE,2018,3,2230,NA,2387,-157,-6.577293674067867
République tchèque,CZE,2018,4,2190,NA,2358,-168,-7.124681933842239
République tchèque,CZE,2018,5,2216,NA,2362,-146,-6.181202370872143
République tchèque,CZE,2018,6,2404,NA,2434,-30,-1.2325390304026294
République tchèque,CZE,2018,7,2602,NA,2441,161,6.5956575174108965
République tchèque,CZE,2018,8,2754,NA,2455,299,12.179226069246436
République tchèque,CZE,2018,9,2819,NA,2430,389,16.008230452674894
République tchèque,CZE,2018,10,2994,NA,2424,570,23.51485148514851
République tchèque,CZE,2018,11,2782,NA,2341,441,18.83810337462623
République tchèque,CZE,2018,12,2607,NA,2264,343,15.150176678445229
République tchèque,CZE,2018,13,2383,NA,2193,190,8.663930688554492
République tchèque,CZE,2018,14,2262,NA,2150,112,5.209302325581396
République tchèque,CZE,2018,15,2257,NA,2118,139,6.562795089707271
République tchèque,CZE,2018,16,2061,NA,2037,24,1.1782032400589102
République tchèque,CZE,2018,17,2090,NA,2090,0,0
République tchèque,CZE,2018,18,2022,NA,2024,-2,-0.09881422924901186
République tchèque,CZE,2018,19,1958,NA,2032,-74,-3.6417322834645667
République tchèque,CZE,2018,20,1962,NA,1981,-19,-0.9591115598182737
République tchèque,CZE,2018,21,2013,NA,1985,28,1.4105793450881612
République tchèque,CZE,2018,22,1995,NA,2041,-46,-2.253797158255757
République tchèque,CZE,2018,23,2038,NA,1947,91,4.673857216230098
République tchèque,CZE,2018,24,1863,NA,1975,-112,-5.670886075949367
République tchèque,CZE,2018,25,1964,NA,1995,-31,-1.5538847117794485
République tchèque,CZE,2018,26,1940,NA,1979,-39,-1.9706922688226376
République tchèque,CZE,2018,27,1979,NA,1966,13,0.6612410986775178
République tchèque,CZE,2018,28,2041,NA,1950,91,4.666666666666667
République tchèque,CZE,2018,29,2039,NA,2006,33,1.6450648055832504
République tchèque,CZE,2018,30,2153,NA,2009,144,7.1677451468392235
République tchèque,CZE,2018,31,2379,NA,2073,306,14.76121562952243
République tchèque,CZE,2018,32,2118,NA,1986,132,6.646525679758309
République tchèque,CZE,2018,33,1923,NA,1940,-17,-0.8762886597938144
République tchèque,CZE,2018,34,2004,NA,1999,5,0.25012506253126565
République tchèque,CZE,2018,35,1902,NA,1955,-53,-2.710997442455243
République tchèque,CZE,2018,36,1979,NA,1950,29,1.4871794871794872
République tchèque,CZE,2018,37,2014,NA,1970,44,2.233502538071066
République tchèque,CZE,2018,38,2056,NA,1994,62,3.1093279839518555
République tchèque,CZE,2018,39,1906,NA,2044,-138,-6.75146771037182
République tchèque,CZE,2018,40,2123,NA,2126,-3,-0.14111006585136407
République tchèque,CZE,2018,41,2076,NA,2128,-52,-2.443609022556391
République tchèque,CZE,2018,42,2014,NA,2071,-57,-2.7522935779816518
République tchèque,CZE,2018,43,2024,NA,2075,-51,-2.457831325301205
République tchèque,CZE,2018,44,2148,NA,2066,82,3.969022265246854
République tchèque,CZE,2018,45,2046,NA,2041,5,0.2449779519843214
République tchèque,CZE,2018,46,1991,NA,2103,-112,-5.325725154541132
République tchèque,CZE,2018,47,2141,NA,2117,24,1.1336797354747286
République tchèque,CZE,2018,48,2095,NA,2118,-23,-1.0859301227573182
République tchèque,CZE,2018,49,2194,NA,2144,50,2.332089552238806
République tchèque,CZE,2018,50,2136,NA,2188,-52,-2.376599634369287
République tchèque,CZE,2018,51,2303,NA,2276,27,1.1862917398945518
République tchèque,CZE,2018,52,2145,NA,2303,-158,-6.860616587060356
République tchèque,CZE,2019,1,2321,NA,2362,-41,-1.7358171041490262
République tchèque,CZE,2019,2,2290,NA,2320,-30,-1.293103448275862
République tchèque,CZE,2019,3,2311,NA,2387,-76,-3.1839128613322165
République tchèque,CZE,2019,4,2365,NA,2358,7,0.2968617472434266
République tchèque,CZE,2019,5,2497,NA,2362,135,5.71549534292972
République tchèque,CZE,2019,6,2445,NA,2434,11,0.4519309778142975
République tchèque,CZE,2019,7,2509,NA,2441,68,2.7857435477263417
République tchèque,CZE,2019,8,2496,NA,2455,41,1.670061099796334
République tchèque,CZE,2019,9,2313,NA,2430,-117,-4.814814814814815
République tchèque,CZE,2019,10,2383,NA,2424,-41,-1.6914191419141915
République tchèque,CZE,2019,11,2262,NA,2341,-79,-3.374626228107646
République tchèque,CZE,2019,12,2198,NA,2264,-66,-2.9151943462897525
République tchèque,CZE,2019,13,2124,NA,2193,-69,-3.146374829001368
République tchèque,CZE,2019,14,2131,NA,2150,-19,-0.8837209302325582
République tchèque,CZE,2019,15,2145,NA,2118,27,1.2747875354107647
République tchèque,CZE,2019,16,2094,NA,2037,57,2.798232695139912
République tchèque,CZE,2019,17,2103,NA,2090,13,0.6220095693779905
République tchèque,CZE,2019,18,2051,NA,2024,27,1.33399209486166
République tchèque,CZE,2019,19,2093,NA,2032,61,3.001968503937008
République tchèque,CZE,2019,20,2025,NA,1981,44,2.221100454316002
République tchèque,CZE,2019,21,1995,NA,1985,10,0.5037783375314862
République tchèque,CZE,2019,22,2093,NA,2041,52,2.547770700636943
République tchèque,CZE,2019,23,2020,NA,1947,73,3.749357986646122
République tchèque,CZE,2019,24,2145,NA,1975,170,8.60759493670886
République tchèque,CZE,2019,25,1980,NA,1995,-15,-0.7518796992481203
République tchèque,CZE,2019,26,2067,NA,1979,88,4.446690247599798
République tchèque,CZE,2019,27,2046,NA,1966,80,4.069175991861648
République tchèque,CZE,2019,28,1956,NA,1950,6,0.3076923076923077
République tchèque,CZE,2019,29,2034,NA,2006,28,1.3958125623130608
République tchèque,CZE,2019,30,2171,NA,2009,162,8.063713290194126
République tchèque,CZE,2019,31,2010,NA,2073,-63,-3.039073806078148
République tchèque,CZE,2019,32,2027,NA,1986,41,2.0644511581067473
République tchèque,CZE,2019,33,2026,NA,1940,86,4.43298969072165
République tchèque,CZE,2019,34,2011,NA,1999,12,0.6003001500750376
République tchèque,CZE,2019,35,2151,NA,1955,196,10.025575447570333
République tchèque,CZE,2019,36,1922,NA,1950,-28,-1.435897435897436
République tchèque,CZE,2019,37,1944,NA,1970,-26,-1.3197969543147208
République tchèque,CZE,2019,38,2030,NA,1994,36,1.8054162487462388
République tchèque,CZE,2019,39,2157,NA,2044,113,5.528375733855186
République tchèque,CZE,2019,40,2153,NA,2126,27,1.2699905926622765
République tchèque,CZE,2019,41,2197,NA,2128,69,3.242481203007519
République tchèque,CZE,2019,42,2099,NA,2071,28,1.3520038628681796
République tchèque,CZE,2019,43,2139,NA,2075,64,3.08433734939759
République tchèque,CZE,2019,44,2066,NA,2066,0,0
République tchèque,CZE,2019,45,2110,NA,2041,69,3.3806957373836357
République tchèque,CZE,2019,46,2231,NA,2103,128,6.086543033761293
République tchèque,CZE,2019,47,2173,NA,2117,56,2.6452527161076995
République tchèque,CZE,2019,48,2134,NA,2118,16,0.7554296506137866
République tchèque,CZE,2019,49,2078,NA,2144,-66,-3.078358208955224
République tchèque,CZE,2019,50,2226,NA,2188,38,1.736745886654479
République tchèque,CZE,2019,51,2248,NA,2276,-28,-1.2302284710017575
République tchèque,CZE,2019,52,2245,NA,2303,-58,-2.5184541901867132
République tchèque,CZE,2020,1,2298,0,2362,-64,-2.7095681625740897
République tchèque,CZE,2020,2,2305,0,2320,-15,-0.646551724137931
République tchèque,CZE,2020,3,2234,0,2387,-153,-6.4097193129451195
République tchèque,CZE,2020,4,2324,0,2358,-34,-1.441899915182358
République tchèque,CZE,2020,5,2357,0,2362,-5,-0.21168501270110077
République tchèque,CZE,2020,6,2346,0,2434,-88,-3.61544782251438
République tchèque,CZE,2020,7,2382,0,2441,-59,-2.417042195821385
République tchèque,CZE,2020,8,2334,0,2455,-121,-4.928716904276985
République tchèque,CZE,2020,9,2344,0,2430,-86,-3.539094650205761
République tchèque,CZE,2020,10,2277,0,2424,-147,-6.064356435643564
République tchèque,CZE,2020,11,2288,0,2341,-53,-2.2639897479709523
République tchèque,CZE,2020,12,2313,1,2264,49,2.1643109540636045
République tchèque,CZE,2020,13,2278,23,2193,85,3.875968992248062
République tchèque,CZE,2020,14,2298,54,2150,148,6.883720930232558
République tchèque,CZE,2020,15,2218,65,2118,100,4.721435316336167
République tchèque,CZE,2020,16,2101,53,2037,64,3.1418753068237604
République tchèque,CZE,2020,17,2008,27,2090,-82,-3.923444976076555
Allemagne,DEU,2016,1,18467,NA,19339,-872,-4.50902321733285
Allemagne,DEU,2016,2,18439,NA,19593,-1154,-5.889858622977593
Allemagne,DEU,2016,3,18627,NA,19524,-897,-4.594345421020283
Allemagne,DEU,2016,4,18707,NA,19855,-1148,-5.781918912112817
Allemagne,DEU,2016,5,18493,NA,20366,-1873,-9.19670038299126
Allemagne,DEU,2016,6,18541,NA,20319,-1778,-8.750430631428712
Allemagne,DEU,2016,7,18483,NA,20636,-2153,-10.433223492924986
Allemagne,DEU,2016,8,18475,NA,20988,-2513,-11.973508671621879
Allemagne,DEU,2016,9,18927,NA,21532,-2605,-12.098272338844511
Allemagne,DEU,2016,10,18888,NA,21288,-2400,-11.273957158962796
Allemagne,DEU,2016,11,18971,NA,20440,-1469,-7.186888454011742
Allemagne,DEU,2016,12,18826,NA,19555,-729,-3.727946816670928
Allemagne,DEU,2016,13,18617,NA,18939,-322,-1.7001953640635725
Allemagne,DEU,2016,14,18245,NA,18480,-235,-1.2716450216450217
Allemagne,DEU,2016,15,17712,NA,17893,-181,-1.0115687699100206
Allemagne,DEU,2016,16,16775,NA,17357,-582,-3.3531140173993204
Allemagne,DEU,2016,17,17053,NA,17407,-354,-2.0336646176825415
Allemagne,DEU,2016,18,16901,NA,16961,-60,-0.3537527268439361
Allemagne,DEU,2016,19,17629,NA,17314,315,1.8193369527549959
Allemagne,DEU,2016,20,16601,NA,16852,-251,-1.4894374554948968
Allemagne,DEU,2016,21,16286,NA,16580,-294,-1.773220747889023
Allemagne,DEU,2016,22,16346,NA,16790,-444,-2.6444312090530078
Allemagne,DEU,2016,23,15799,NA,16446,-647,-3.9340873160646965
Allemagne,DEU,2016,24,15717,NA,15947,-230,-1.4422775443657114
Allemagne,DEU,2016,25,16910,NA,16538,372,2.24936509856089
Allemagne,DEU,2016,26,15699,NA,16550,-851,-5.141993957703928
Allemagne,DEU,2016,27,16229,NA,16441,-212,-1.2894592786326866
Allemagne,DEU,2016,28,16172,NA,16026,146,0.9110195931611131
Allemagne,DEU,2016,29,16985,NA,16764,221,1.3183011214507279
Allemagne,DEU,2016,30,16157,NA,17542,-1385,-7.895336905712005
Allemagne,DEU,2016,31,15439,NA,17320,-1881,-10.86027713625866
Allemagne,DEU,2016,32,15487,NA,16562,-1075,-6.490761985267479
Allemagne,DEU,2016,33,16258,NA,16304,-46,-0.28213935230618253
Allemagne,DEU,2016,34,17147,NA,16461,686,4.167426037300285
Allemagne,DEU,2016,35,16101,NA,16442,-341,-2.0739569395450674
Allemagne,DEU,2016,36,16116,NA,16040,76,0.4738154613466334
Allemagne,DEU,2016,37,16372,NA,16262,110,0.6764235641372525
Allemagne,DEU,2016,38,15606,NA,16306,-700,-4.292898319636943
Allemagne,DEU,2016,39,16336,NA,16603,-267,-1.6081431066674696
Allemagne,DEU,2016,40,16352,NA,16625,-273,-1.6421052631578947
Allemagne,DEU,2016,41,17427,NA,17376,51,0.2935082872928177
Allemagne,DEU,2016,42,17599,NA,17229,370,2.1475419351094085
Allemagne,DEU,2016,43,17586,NA,17120,466,2.72196261682243
Allemagne,DEU,2016,44,17580,NA,17143,437,2.549145423788135
Allemagne,DEU,2016,45,17782,NA,17616,166,0.9423251589464123
Allemagne,DEU,2016,46,18591,NA,17780,811,4.5613048368953875
Allemagne,DEU,2016,47,17911,NA,17954,-43,-0.23950094686420853
Allemagne,DEU,2016,48,18147,NA,18171,-24,-0.13207858675912168
Allemagne,DEU,2016,49,18793,NA,18678,115,0.6156976121640433
Allemagne,DEU,2016,50,18885,NA,18606,279,1.4995162850693324
Allemagne,DEU,2016,51,19376,NA,18978,398,2.0971651385815155
Allemagne,DEU,2016,52,19744,NA,18621,1123,6.030825412169056
Allemagne,DEU,2017,1,20918,NA,19339,1579,8.164848234138269
Allemagne,DEU,2017,2,22070,NA,19593,2477,12.642270198540295
Allemagne,DEU,2017,3,21236,NA,19524,1712,8.768694939561565
Allemagne,DEU,2017,4,22083,NA,19855,2228,11.221354822462857
Allemagne,DEU,2017,5,23640,NA,20366,3274,16.07581262889129
Allemagne,DEU,2017,6,22745,NA,20319,2426,11.939563954919041
Allemagne,DEU,2017,7,22683,NA,20636,2047,9.919558053886412
Allemagne,DEU,2017,8,22267,NA,20988,1279,6.0939584524490185
Allemagne,DEU,2017,9,20930,NA,21532,-602,-2.795838751625488
Allemagne,DEU,2017,10,19102,NA,21288,-2186,-10.26869597895528
Allemagne,DEU,2017,11,18665,NA,20440,-1775,-8.683953033268102
Allemagne,DEU,2017,12,17640,NA,19555,-1915,-9.792891843518282
Allemagne,DEU,2017,13,17731,NA,18939,-1208,-6.378372670151538
Allemagne,DEU,2017,14,17028,NA,18480,-1452,-7.857142857142857
Allemagne,DEU,2017,15,16901,NA,17893,-992,-5.5440675124350305
Allemagne,DEU,2017,16,16637,NA,17357,-720,-4.1481822895661695
Allemagne,DEU,2017,17,17634,NA,17407,227,1.3040730740506692
Allemagne,DEU,2017,18,17129,NA,16961,168,0.990507635163021
Allemagne,DEU,2017,19,17343,NA,17314,29,0.1674945131107774
Allemagne,DEU,2017,20,17079,NA,16852,227,1.34702112508901
Allemagne,DEU,2017,21,16451,NA,16580,-129,-0.7780458383594692
Allemagne,DEU,2017,22,16902,NA,16790,112,0.6670637284097677
Allemagne,DEU,2017,23,15846,NA,16446,-600,-3.6483035388544325
Allemagne,DEU,2017,24,16087,NA,15947,140,0.8779080704834765
Allemagne,DEU,2017,25,16819,NA,16538,281,1.6991171846656186
Allemagne,DEU,2017,26,16076,NA,16550,-474,-2.8640483383685797
Allemagne,DEU,2017,27,16424,NA,16441,-17,-0.10340003649413053
Allemagne,DEU,2017,28,15603,NA,16026,-423,-2.6394608760763756
Allemagne,DEU,2017,29,16589,NA,16764,-175,-1.043903602958721
Allemagne,DEU,2017,30,16058,NA,17542,-1484,-8.459696727853153
Allemagne,DEU,2017,31,16494,NA,17320,-826,-4.76905311778291
Allemagne,DEU,2017,32,15784,NA,16562,-778,-4.697500301895906
Allemagne,DEU,2017,33,16149,NA,16304,-155,-0.9506869479882237
Allemagne,DEU,2017,34,15880,NA,16461,-581,-3.529554705060446
Allemagne,DEU,2017,35,16064,NA,16442,-378,-2.298990390463447
Allemagne,DEU,2017,36,15707,NA,16040,-333,-2.076059850374065
Allemagne,DEU,2017,37,16147,NA,16262,-115,-0.7071700897798548
Allemagne,DEU,2017,38,16505,NA,16306,199,1.2204096651539311
Allemagne,DEU,2017,39,16747,NA,16603,144,0.8673131361802083
Allemagne,DEU,2017,40,16664,NA,16625,39,0.2345864661654135
Allemagne,DEU,2017,41,17470,NA,17376,94,0.5409760589318601
Allemagne,DEU,2017,42,17139,NA,17229,-90,-0.5223750652968832
Allemagne,DEU,2017,43,17059,NA,17120,-61,-0.35630841121495327
Allemagne,DEU,2017,44,16762,NA,17143,-381,-2.2224814793210057
Allemagne,DEU,2017,45,17371,NA,17616,-245,-1.3907811080835604
Allemagne,DEU,2017,46,17595,NA,17780,-185,-1.0404949381327335
Allemagne,DEU,2017,47,17677,NA,17954,-277,-1.5428316809624596
Allemagne,DEU,2017,48,17877,NA,18171,-294,-1.6179626877992408
Allemagne,DEU,2017,49,18295,NA,18678,-383,-2.0505407431202483
Allemagne,DEU,2017,50,18504,NA,18606,-102,-0.5482102547565302
Allemagne,DEU,2017,51,18502,NA,18978,-476,-2.508167351670355
Allemagne,DEU,2017,52,18652,NA,18621,31,0.16647870683636753
Allemagne,DEU,2018,1,19342,NA,19339,3,0.015512694555044212
Allemagne,DEU,2018,2,18770,NA,19593,-823,-4.200479763180728
Allemagne,DEU,2018,3,19187,NA,19524,-337,-1.7260807211636962
Allemagne,DEU,2018,4,19171,NA,19855,-684,-3.4449760765550237
Allemagne,DEU,2018,5,19558,NA,20366,-808,-3.967396641461259
Allemagne,DEU,2018,6,20086,NA,20319,-233,-1.14670997588464
Allemagne,DEU,2018,7,21254,NA,20636,618,2.9947664276022485
Allemagne,DEU,2018,8,22888,NA,20988,1900,9.052792071659995
Allemagne,DEU,2018,9,25535,NA,21532,4003,18.5909344231841
Allemagne,DEU,2018,10,26777,NA,21288,5489,25.784479518977825
Allemagne,DEU,2018,11,24385,NA,20440,3945,19.300391389432487
Allemagne,DEU,2018,12,22777,NA,19555,3222,16.476604448990027
Allemagne,DEU,2018,13,20906,NA,18939,1967,10.385976028301389
Allemagne,DEU,2018,14,20038,NA,18480,1558,8.43073593073593
Allemagne,DEU,2018,15,19165,NA,17893,1272,7.108925278041692
Allemagne,DEU,2018,16,17992,NA,17357,635,3.658466324825719
Allemagne,DEU,2018,17,17093,NA,17407,-314,-1.8038720055150226
Allemagne,DEU,2018,18,16789,NA,16961,-172,-1.0140911502859502
Allemagne,DEU,2018,19,17226,NA,17314,-88,-0.5082592121982211
Allemagne,DEU,2018,20,16488,NA,16852,-364,-2.159981011155946
Allemagne,DEU,2018,21,16513,NA,16580,-67,-0.40410132689987943
Allemagne,DEU,2018,22,17039,NA,16790,249,1.48302561048243
Allemagne,DEU,2018,23,16714,NA,16446,268,1.6295755806883132
Allemagne,DEU,2018,24,15582,NA,15947,-365,-2.288831755189064
Allemagne,DEU,2018,25,15843,NA,16538,-695,-4.20244285887048
Allemagne,DEU,2018,26,16569,NA,16550,19,0.1148036253776435
Allemagne,DEU,2018,27,16622,NA,16441,181,1.1009062709080955
Allemagne,DEU,2018,28,16070,NA,16026,44,0.27455384999376015
Allemagne,DEU,2018,29,16702,NA,16764,-62,-0.36984013361966117
Allemagne,DEU,2018,30,18340,NA,17542,798,4.549082202713488
Allemagne,DEU,2018,31,20371,NA,17320,3051,17.615473441108545
Allemagne,DEU,2018,32,18478,NA,16562,1916,11.56865112909069
Allemagne,DEU,2018,33,16890,NA,16304,586,3.5942100098135428
Allemagne,DEU,2018,34,16612,NA,16461,151,0.9173197254115788
Allemagne,DEU,2018,35,16000,NA,16442,-442,-2.688237440700645
Allemagne,DEU,2018,36,16390,NA,16040,350,2.182044887780549
Allemagne,DEU,2018,37,16292,NA,16262,30,0.1844791538556143
Allemagne,DEU,2018,38,16651,NA,16306,345,2.1157856003924937
Allemagne,DEU,2018,39,15969,NA,16603,-634,-3.818587002348973
Allemagne,DEU,2018,40,16622,NA,16625,-3,-0.01804511278195489
Allemagne,DEU,2018,41,16993,NA,17376,-383,-2.2041896869244937
Allemagne,DEU,2018,42,16552,NA,17229,-677,-3.929421324510999
Allemagne,DEU,2018,43,16608,NA,17120,-512,-2.990654205607477
Allemagne,DEU,2018,44,16895,NA,17143,-248,-1.4466546112115732
Allemagne,DEU,2018,45,17604,NA,17616,-12,-0.06811989100817438
Allemagne,DEU,2018,46,16842,NA,17780,-938,-5.275590551181102
Allemagne,DEU,2018,47,17785,NA,17954,-169,-0.9412944190709591
Allemagne,DEU,2018,48,18091,NA,18171,-80,-0.4402619558637389
Allemagne,DEU,2018,49,18342,NA,18678,-336,-1.7989078059749437
Allemagne,DEU,2018,50,17943,NA,18606,-663,-3.563366655917446
Allemagne,DEU,2018,51,18990,NA,18978,12,0.06323110970597534
Allemagne,DEU,2018,52,17954,NA,18621,-667,-3.581977337414747
Allemagne,DEU,2019,1,18628,NA,19339,-711,-3.6765086095454778
Allemagne,DEU,2019,2,19092,NA,19593,-501,-2.557035676006737
Allemagne,DEU,2019,3,19046,NA,19524,-478,-2.4482687973775863
Allemagne,DEU,2019,4,19458,NA,19855,-397,-1.9994963485268196
Allemagne,DEU,2019,5,19774,NA,20366,-592,-2.9068054600805264
Allemagne,DEU,2019,6,19905,NA,20319,-414,-2.037501845563266
Allemagne,DEU,2019,7,20125,NA,20636,-511,-2.4762550881953866
Allemagne,DEU,2019,8,20321,NA,20988,-667,-3.178006479893272
Allemagne,DEU,2019,9,20737,NA,21532,-795,-3.6921790822961174
Allemagne,DEU,2019,10,20386,NA,21288,-902,-4.237128898910184
Allemagne,DEU,2019,11,19738,NA,20440,-702,-3.434442270058708
Allemagne,DEU,2019,12,18976,NA,19555,-579,-2.960879570442342
Allemagne,DEU,2019,13,18501,NA,18939,-438,-2.3126881039125613
Allemagne,DEU,2019,14,18608,NA,18480,128,0.6926406926406926
Allemagne,DEU,2019,15,17794,NA,17893,-99,-0.5532889956966411
Allemagne,DEU,2019,16,18025,NA,17357,668,3.8485913464308346
Allemagne,DEU,2019,17,17849,NA,17407,442,2.539208364451083
Allemagne,DEU,2019,18,17024,NA,16961,63,0.37144036318613294
Allemagne,DEU,2019,19,17059,NA,17314,-255,-1.4727965808016634
Allemagne,DEU,2019,20,17239,NA,16852,387,2.2964633277949202
Allemagne,DEU,2019,21,17068,NA,16580,488,2.9433051869722555
Allemagne,DEU,2019,22,16873,NA,16790,83,0.49434187016081005
Allemagne,DEU,2019,23,17426,NA,16446,980,5.958895780128906
Allemagne,DEU,2019,24,16403,NA,15947,456,2.8594720010033234
Allemagne,DEU,2019,25,16581,NA,16538,43,0.260007256016447
Allemagne,DEU,2019,26,17854,NA,16550,1304,7.879154078549849
Allemagne,DEU,2019,27,16489,NA,16441,48,0.2919530442187215
Allemagne,DEU,2019,28,16260,NA,16026,234,1.4601272931486335
Allemagne,DEU,2019,29,16779,NA,16764,15,0.08947745168217609
Allemagne,DEU,2019,30,19614,NA,17542,2072,11.811652035115722
Allemagne,DEU,2019,31,16974,NA,17320,-346,-1.997690531177829
Allemagne,DEU,2019,32,16501,NA,16562,-61,-0.36831300567564307
Allemagne,DEU,2019,33,15918,NA,16304,-386,-2.3675171736997056
Allemagne,DEU,2019,34,16205,NA,16461,-256,-1.5551910576514185
Allemagne,DEU,2019,35,17601,NA,16442,1159,7.049020800389247
Allemagne,DEU,2019,36,15949,NA,16040,-91,-0.5673316708229427
Allemagne,DEU,2019,37,16235,NA,16262,-27,-0.16603123847005288
Allemagne,DEU,2019,38,16460,NA,16306,154,0.9444376303201276
Allemagne,DEU,2019,39,17361,NA,16603,758,4.565439980726374
Allemagne,DEU,2019,40,16862,NA,16625,237,1.4255639097744361
Allemagne,DEU,2019,41,17615,NA,17376,239,1.3754604051565378
Allemagne,DEU,2019,42,17626,NA,17229,397,2.3042544546984733
Allemagne,DEU,2019,43,17229,NA,17120,109,0.6366822429906542
Allemagne,DEU,2019,44,17334,NA,17143,191,1.1141573820218165
Allemagne,DEU,2019,45,17708,NA,17616,92,0.5222524977293369
Allemagne,DEU,2019,46,18093,NA,17780,313,1.7604049493813272
Allemagne,DEU,2019,47,18445,NA,17954,491,2.734766625821544
Allemagne,DEU,2019,48,18569,NA,18171,398,2.190303230422101
Allemagne,DEU,2019,49,19280,NA,18678,602,3.223043152371774
Allemagne,DEU,2019,50,19092,NA,18606,486,2.6120606256046437
Allemagne,DEU,2019,51,19046,NA,18978,68,0.3583096216671936
Allemagne,DEU,2019,52,18135,NA,18621,-486,-2.609956500724988
Allemagne,DEU,2020,1,18853,0,19339,-486,-2.5130565179171622
Allemagne,DEU,2020,2,19403,0,19593,-190,-0.9697340887051499
Allemagne,DEU,2020,3,19135,0,19524,-389,-1.992419586150379
Allemagne,DEU,2020,4,18915,0,19855,-940,-4.734323847897255
Allemagne,DEU,2020,5,19734,0,20366,-632,-3.1032112344102916
Allemagne,DEU,2020,6,18957,0,20319,-1362,-6.703085781780599
Allemagne,DEU,2020,7,19558,0,20636,-1078,-5.223880597014925
Allemagne,DEU,2020,8,18877,0,20988,-2111,-10.05812845435487
Allemagne,DEU,2020,9,19391,0,21532,-2141,-9.943340144900613
Allemagne,DEU,2020,10,19552,2,21288,-1736,-8.154829011649756
Allemagne,DEU,2020,11,19745,11,20440,-695,-3.4001956947162424
Allemagne,DEU,2020,12,19593,113,19555,38,0.19432370237790847
Allemagne,DEU,2020,13,19580,457,18939,641,3.384550398648292
Allemagne,DEU,2020,14,20478,1024,18480,1998,10.811688311688311
Allemagne,DEU,2020,15,20296,1362,17893,2403,13.429832895545744
Allemagne,DEU,2020,16,19063,1629,17357,1706,9.828887480555396
Allemagne,DEU,2020,17,18301,1315,17407,894,5.135864881944046
Allemagne,DEU,2020,18,17612,918,16961,651,3.838217086256707
Allemagne,DEU,2020,19,17229,702,17314,-85,-0.4909321936005544
Allemagne,DEU,2020,20,16383,474,16852,-469,-2.7830524566816996
Danemark,DNK,2016,1,1103,NA,1120,-17,-1.5178571428571428
Danemark,DNK,2016,2,1065,NA,1117,-52,-4.6553267681289165
Danemark,DNK,2016,3,1046,NA,1105,-59,-5.339366515837104
Danemark,DNK,2016,4,1124,NA,1108,16,1.444043321299639
Danemark,DNK,2016,5,1083,NA,1165,-82,-7.03862660944206
Danemark,DNK,2016,6,1040,NA,1144,-104,-9.090909090909092
Danemark,DNK,2016,7,1062,NA,1183,-121,-10.228233305156383
Danemark,DNK,2016,8,1124,NA,1162,-38,-3.2702237521514634
Danemark,DNK,2016,9,1143,NA,1184,-41,-3.4628378378378377
Danemark,DNK,2016,10,1149,NA,1160,-11,-0.9482758620689655
Danemark,DNK,2016,11,1159,NA,1152,7,0.607638888888889
Danemark,DNK,2016,12,1074,NA,1131,-57,-5.039787798408488
Danemark,DNK,2016,13,1084,NA,1083,1,0.09233610341643582
Danemark,DNK,2016,14,1023,NA,1058,-35,-3.30812854442344
Danemark,DNK,2016,15,1071,NA,1066,5,0.46904315196998125
Danemark,DNK,2016,16,1010,NA,1019,-9,-0.8832188420019628
Danemark,DNK,2016,17,985,NA,996,-11,-1.104417670682731
Danemark,DNK,2016,18,1042,NA,1044,-2,-0.19157088122605362
Danemark,DNK,2016,19,1023,NA,1023,0,0
Danemark,DNK,2016,20,935,NA,986,-51,-5.172413793103448
Danemark,DNK,2016,21,975,NA,967,8,0.8273009307135472
Danemark,DNK,2016,22,953,NA,967,-14,-1.4477766287487073
Danemark,DNK,2016,23,913,NA,974,-61,-6.262833675564681
Danemark,DNK,2016,24,920,NA,963,-43,-4.46521287642783
Danemark,DNK,2016,25,983,NA,984,-1,-0.10162601626016261
Danemark,DNK,2016,26,897,NA,938,-41,-4.371002132196162
Danemark,DNK,2016,27,924,NA,943,-19,-2.014846235418876
Danemark,DNK,2016,28,898,NA,941,-43,-4.569606801275238
Danemark,DNK,2016,29,971,NA,968,3,0.30991735537190085
Danemark,DNK,2016,30,962,NA,986,-24,-2.434077079107505
Danemark,DNK,2016,31,902,NA,970,-68,-7.010309278350515
Danemark,DNK,2016,32,956,NA,963,-7,-0.726895119418484
Danemark,DNK,2016,33,914,NA,942,-28,-2.9723991507431
Danemark,DNK,2016,34,971,NA,980,-9,-0.9183673469387756
Danemark,DNK,2016,35,922,NA,951,-29,-3.0494216614090432
Danemark,DNK,2016,36,955,NA,958,-3,-0.31315240083507306
Danemark,DNK,2016,37,932,NA,960,-28,-2.9166666666666665
Danemark,DNK,2016,38,904,NA,971,-67,-6.90010298661174
Danemark,DNK,2016,39,983,NA,983,0,0
Danemark,DNK,2016,40,910,NA,973,-63,-6.474820143884892
Danemark,DNK,2016,41,1022,NA,1008,14,1.3888888888888888
Danemark,DNK,2016,42,1040,NA,992,48,4.838709677419355
Danemark,DNK,2016,43,989,NA,980,9,0.9183673469387756
Danemark,DNK,2016,44,1003,NA,985,18,1.8274111675126905
Danemark,DNK,2016,45,1017,NA,1003,14,1.3958125623130608
Danemark,DNK,2016,46,1045,NA,1026,19,1.8518518518518516
Danemark,DNK,2016,47,1046,NA,1028,18,1.7509727626459144
Danemark,DNK,2016,48,1010,NA,1032,-22,-2.131782945736434
Danemark,DNK,2016,49,1043,NA,1075,-32,-2.9767441860465116
Danemark,DNK,2016,50,1067,NA,1080,-13,-1.2037037037037037
Danemark,DNK,2016,51,1060,NA,1064,-4,-0.37593984962406013
Danemark,DNK,2016,52,1149,NA,1082,67,6.1922365988909425
Danemark,DNK,2017,1,1113,NA,1120,-7,-0.625
Danemark,DNK,2017,2,1111,NA,1117,-6,-0.5371530886302597
Danemark,DNK,2017,3,1099,NA,1105,-6,-0.5429864253393665
Danemark,DNK,2017,4,1104,NA,1108,-4,-0.36101083032490977
Danemark,DNK,2017,5,1211,NA,1165,46,3.9484978540772535
Danemark,DNK,2017,6,1100,NA,1144,-44,-3.8461538461538463
Danemark,DNK,2017,7,1228,NA,1183,45,3.8038884192730347
Danemark,DNK,2017,8,1156,NA,1162,-6,-0.5163511187607573
Danemark,DNK,2017,9,1179,NA,1184,-5,-0.4222972972972973
Danemark,DNK,2017,10,1101,NA,1160,-59,-5.086206896551724
Danemark,DNK,2017,11,1132,NA,1152,-20,-1.7361111111111112
Danemark,DNK,2017,12,1126,NA,1131,-5,-0.4420866489832007
Danemark,DNK,2017,13,1041,NA,1083,-42,-3.8781163434903045
Danemark,DNK,2017,14,988,NA,1058,-70,-6.61625708884688
Danemark,DNK,2017,15,1009,NA,1066,-57,-5.347091932457786
Danemark,DNK,2017,16,967,NA,1019,-52,-5.103042198233562
Danemark,DNK,2017,17,974,NA,996,-22,-2.208835341365462
Danemark,DNK,2017,18,1059,NA,1044,15,1.4367816091954022
Danemark,DNK,2017,19,1015,NA,1023,-8,-0.7820136852394917
Danemark,DNK,2017,20,1022,NA,986,36,3.6511156186612577
Danemark,DNK,2017,21,969,NA,967,2,0.2068252326783868
Danemark,DNK,2017,22,956,NA,967,-11,-1.1375387797311272
Danemark,DNK,2017,23,985,NA,974,11,1.1293634496919918
Danemark,DNK,2017,24,1023,NA,963,60,6.230529595015576
Danemark,DNK,2017,25,980,NA,984,-4,-0.40650406504065045
Danemark,DNK,2017,26,938,NA,938,0,0
Danemark,DNK,2017,27,905,NA,943,-38,-4.029692470837752
Danemark,DNK,2017,28,941,NA,941,0,0
Danemark,DNK,2017,29,931,NA,968,-37,-3.8223140495867765
Danemark,DNK,2017,30,925,NA,986,-61,-6.186612576064909
Danemark,DNK,2017,31,934,NA,970,-36,-3.711340206185567
Danemark,DNK,2017,32,932,NA,963,-31,-3.2191069574247146
Danemark,DNK,2017,33,906,NA,942,-36,-3.821656050955414
Danemark,DNK,2017,34,953,NA,980,-27,-2.7551020408163267
Danemark,DNK,2017,35,951,NA,951,0,0
Danemark,DNK,2017,36,918,NA,958,-40,-4.175365344467641
Danemark,DNK,2017,37,991,NA,960,31,3.229166666666667
Danemark,DNK,2017,38,979,NA,971,8,0.8238928939237898
Danemark,DNK,2017,39,983,NA,983,0,0
Danemark,DNK,2017,40,978,NA,973,5,0.513874614594039
Danemark,DNK,2017,41,985,NA,1008,-23,-2.2817460317460316
Danemark,DNK,2017,42,970,NA,992,-22,-2.217741935483871
Danemark,DNK,2017,43,934,NA,980,-46,-4.6938775510204085
Danemark,DNK,2017,44,976,NA,985,-9,-0.9137055837563453
Danemark,DNK,2017,45,956,NA,1003,-47,-4.685942173479561
Danemark,DNK,2017,46,1070,NA,1026,44,4.28849902534113
Danemark,DNK,2017,47,1011,NA,1028,-17,-1.6536964980544748
Danemark,DNK,2017,48,1027,NA,1032,-5,-0.4844961240310077
Danemark,DNK,2017,49,1067,NA,1075,-8,-0.7441860465116279
Danemark,DNK,2017,50,1102,NA,1080,22,2.037037037037037
Danemark,DNK,2017,51,1058,NA,1064,-6,-0.5639097744360901
Danemark,DNK,2017,52,1134,NA,1082,52,4.805914972273567
Danemark,DNK,2018,1,1134,NA,1120,14,1.25
Danemark,DNK,2018,2,1136,NA,1117,19,1.7009847806624887
Danemark,DNK,2018,3,1156,NA,1105,51,4.615384615384616
Danemark,DNK,2018,4,1119,NA,1108,11,0.9927797833935018
Danemark,DNK,2018,5,1157,NA,1165,-8,-0.6866952789699571
Danemark,DNK,2018,6,1186,NA,1144,42,3.6713286713286712
Danemark,DNK,2018,7,1265,NA,1183,82,6.931530008453085
Danemark,DNK,2018,8,1260,NA,1162,98,8.433734939759036
Danemark,DNK,2018,9,1323,NA,1184,139,11.739864864864865
Danemark,DNK,2018,10,1337,NA,1160,177,15.258620689655173
Danemark,DNK,2018,11,1253,NA,1152,101,8.76736111111111
Danemark,DNK,2018,12,1286,NA,1131,155,13.704686118479223
Danemark,DNK,2018,13,1186,NA,1083,103,9.510618651892889
Danemark,DNK,2018,14,1138,NA,1058,80,7.561436672967864
Danemark,DNK,2018,15,1164,NA,1066,98,9.193245778611631
Danemark,DNK,2018,16,1052,NA,1019,33,3.23846908734053
Danemark,DNK,2018,17,1008,NA,996,12,1.2048192771084338
Danemark,DNK,2018,18,1010,NA,1044,-34,-3.256704980842912
Danemark,DNK,2018,19,1025,NA,1023,2,0.19550342130987292
Danemark,DNK,2018,20,1012,NA,986,26,2.636916835699797
Danemark,DNK,2018,21,953,NA,967,-14,-1.4477766287487073
Danemark,DNK,2018,22,977,NA,967,10,1.0341261633919339
Danemark,DNK,2018,23,1009,NA,974,35,3.5934291581108826
Danemark,DNK,2018,24,941,NA,963,-22,-2.284527518172378
Danemark,DNK,2018,25,958,NA,984,-26,-2.642276422764228
Danemark,DNK,2018,26,915,NA,938,-23,-2.4520255863539444
Danemark,DNK,2018,27,1007,NA,943,64,6.786850477200425
Danemark,DNK,2018,28,971,NA,941,30,3.1880977683315623
Danemark,DNK,2018,29,994,NA,968,26,2.6859504132231407
Danemark,DNK,2018,30,1091,NA,986,105,10.649087221095336
Danemark,DNK,2018,31,1084,NA,970,114,11.752577319587628
Danemark,DNK,2018,32,1029,NA,963,66,6.853582554517133
Danemark,DNK,2018,33,1017,NA,942,75,7.961783439490445
Danemark,DNK,2018,34,990,NA,980,10,1.0204081632653061
Danemark,DNK,2018,35,935,NA,951,-16,-1.6824395373291272
Danemark,DNK,2018,36,975,NA,958,17,1.7745302713987474
Danemark,DNK,2018,37,949,NA,960,-11,-1.1458333333333333
Danemark,DNK,2018,38,994,NA,971,23,2.368692070030896
Danemark,DNK,2018,39,950,NA,983,-33,-3.3570701932858595
Danemark,DNK,2018,40,1033,NA,973,60,6.166495375128469
Danemark,DNK,2018,41,992,NA,1008,-16,-1.5873015873015872
Danemark,DNK,2018,42,958,NA,992,-34,-3.4274193548387095
Danemark,DNK,2018,43,973,NA,980,-7,-0.7142857142857143
Danemark,DNK,2018,44,1007,NA,985,22,2.233502538071066
Danemark,DNK,2018,45,992,NA,1003,-11,-1.0967098703888334
Danemark,DNK,2018,46,954,NA,1026,-72,-7.017543859649122
Danemark,DNK,2018,47,996,NA,1028,-32,-3.11284046692607
Danemark,DNK,2018,48,994,NA,1032,-38,-3.6821705426356592
Danemark,DNK,2018,49,1085,NA,1075,10,0.9302325581395349
Danemark,DNK,2018,50,1044,NA,1080,-36,-3.3333333333333335
Danemark,DNK,2018,51,1096,NA,1064,32,3.007518796992481
Danemark,DNK,2018,52,1006,NA,1082,-76,-7.024029574861368
Danemark,DNK,2019,1,1130,NA,1120,10,0.8928571428571428
Danemark,DNK,2019,2,1155,NA,1117,38,3.4019695613249774
Danemark,DNK,2019,3,1118,NA,1105,13,1.1764705882352942
Danemark,DNK,2019,4,1085,NA,1108,-23,-2.0758122743682312
Danemark,DNK,2019,5,1209,NA,1165,44,3.776824034334764
Danemark,DNK,2019,6,1250,NA,1144,106,9.265734265734265
Danemark,DNK,2019,7,1176,NA,1183,-7,-0.591715976331361
Danemark,DNK,2019,8,1110,NA,1162,-52,-4.475043029259897
Danemark,DNK,2019,9,1090,NA,1184,-94,-7.939189189189189
Danemark,DNK,2019,10,1051,NA,1160,-109,-9.39655172413793
Danemark,DNK,2019,11,1063,NA,1152,-89,-7.725694444444445
Danemark,DNK,2019,12,1039,NA,1131,-92,-8.134394341290893
Danemark,DNK,2019,13,1022,NA,1083,-61,-5.632502308402586
Danemark,DNK,2019,14,1085,NA,1058,27,2.551984877126654
Danemark,DNK,2019,15,1018,NA,1066,-48,-4.50281425891182
Danemark,DNK,2019,16,1046,NA,1019,27,2.649656526005888
Danemark,DNK,2019,17,1015,NA,996,19,1.9076305220883536
Danemark,DNK,2019,18,1067,NA,1044,23,2.203065134099617
Danemark,DNK,2019,19,1028,NA,1023,5,0.4887585532746823
Danemark,DNK,2019,20,974,NA,986,-12,-1.2170385395537524
Danemark,DNK,2019,21,970,NA,967,3,0.3102378490175801
Danemark,DNK,2019,22,983,NA,967,16,1.6546018614270943
Danemark,DNK,2019,23,991,NA,974,17,1.7453798767967144
Danemark,DNK,2019,24,969,NA,963,6,0.6230529595015576
Danemark,DNK,2019,25,1015,NA,984,31,3.1504065040650406
Danemark,DNK,2019,26,1002,NA,938,64,6.823027718550106
Danemark,DNK,2019,27,935,NA,943,-8,-0.8483563096500532
Danemark,DNK,2019,28,953,NA,941,12,1.2752391073326248
Danemark,DNK,2019,29,977,NA,968,9,0.9297520661157025
Danemark,DNK,2019,30,967,NA,986,-19,-1.9269776876267748
Danemark,DNK,2019,31,962,NA,970,-8,-0.8247422680412372
Danemark,DNK,2019,32,936,NA,963,-27,-2.803738317757009
Danemark,DNK,2019,33,931,NA,942,-11,-1.167728237791932
Danemark,DNK,2019,34,1006,NA,980,26,2.6530612244897958
Danemark,DNK,2019,35,996,NA,951,45,4.73186119873817
Danemark,DNK,2019,36,983,NA,958,25,2.6096033402922756
Danemark,DNK,2019,37,966,NA,960,6,0.625
Danemark,DNK,2019,38,1007,NA,971,36,3.7075180226570548
Danemark,DNK,2019,39,1016,NA,983,33,3.3570701932858595
Danemark,DNK,2019,40,972,NA,973,-1,-0.10277492291880781
Danemark,DNK,2019,41,1033,NA,1008,25,2.4801587301587302
Danemark,DNK,2019,42,998,NA,992,6,0.6048387096774194
Danemark,DNK,2019,43,1026,NA,980,46,4.6938775510204085
Danemark,DNK,2019,44,954,NA,985,-31,-3.1472081218274113
Danemark,DNK,2019,45,1046,NA,1003,43,4.287138584247258
Danemark,DNK,2019,46,1037,NA,1026,11,1.0721247563352825
Danemark,DNK,2019,47,1057,NA,1028,29,2.821011673151751
Danemark,DNK,2019,48,1095,NA,1032,63,6.104651162790697
Danemark,DNK,2019,49,1104,NA,1075,29,2.697674418604651
Danemark,DNK,2019,50,1107,NA,1080,27,2.5
Danemark,DNK,2019,51,1042,NA,1064,-22,-2.0676691729323307
Danemark,DNK,2019,52,1038,NA,1082,-44,-4.066543438077634
Danemark,DNK,2020,1,1116,0,1120,-4,-0.35714285714285715
Danemark,DNK,2020,2,1149,0,1117,32,2.864816472694718
Danemark,DNK,2020,3,1068,0,1105,-37,-3.3484162895927603
Danemark,DNK,2020,4,1025,0,1108,-83,-7.490974729241877
Danemark,DNK,2020,5,1087,0,1165,-78,-6.695278969957082
Danemark,DNK,2020,6,1078,0,1144,-66,-5.769230769230769
Danemark,DNK,2020,7,1057,0,1183,-126,-10.650887573964498
Danemark,DNK,2020,8,1034,0,1162,-128,-11.015490533562824
Danemark,DNK,2020,9,1021,0,1184,-163,-13.766891891891891
Danemark,DNK,2020,10,1060,0,1160,-100,-8.620689655172415
Danemark,DNK,2020,11,1064,1,1152,-88,-7.638888888888889
Danemark,DNK,2020,12,1138,23,1131,7,0.618921308576481
Danemark,DNK,2020,13,1108,53,1083,25,2.308402585410896
Danemark,DNK,2020,14,1153,110,1058,95,8.979206049149338
Danemark,DNK,2020,15,1141,98,1066,75,7.0356472795497185
Danemark,DNK,2020,16,1072,79,1019,53,5.20117762512267
Danemark,DNK,2020,17,1082,63,996,86,8.634538152610443
Danemark,DNK,2020,18,1043,63,1044,-1,-0.09578544061302681
Danemark,DNK,2020,19,1020,34,1023,-3,-0.2932551319648094
Danemark,DNK,2020,20,948,24,986,-38,-3.8539553752535496
Danemark,DNK,2020,21,991,15,967,24,2.481902792140641
Danemark,DNK,2020,22,960,13,967,-7,-0.7238883143743536
Danemark,DNK,2020,23,944,17,974,-30,-3.0800821355236137
Espagne,ESP,2016,1,8658,NA,9929,-1271,-12.800886292678012
Espagne,ESP,2016,2,8671,NA,10252,-1581,-15.421381193913383
Espagne,ESP,2016,3,8791,NA,10395,-1604,-15.43049543049543
Espagne,ESP,2016,4,8491,NA,10006,-1515,-15.140915450729562
Espagne,ESP,2016,5,8461,NA,9738,-1277,-13.113575682891765
Espagne,ESP,2016,6,8556,NA,9477,-921,-9.71826527382083
Espagne,ESP,2016,7,8479,NA,9240,-761,-8.235930735930735
Espagne,ESP,2016,8,8670,NA,9052,-382,-4.220061864781264
Espagne,ESP,2016,9,8645,NA,8884,-239,-2.690229626294462
Espagne,ESP,2016,10,8653,NA,8664,-11,-0.12696214219759927
Espagne,ESP,2016,11,8811,NA,8445,366,4.33392539964476
Espagne,ESP,2016,12,8291,NA,8201,90,1.0974271430313376
Espagne,ESP,2016,13,8375,NA,8250,125,1.5151515151515151
Espagne,ESP,2016,14,7998,NA,8077,-79,-0.9780859229912096
Espagne,ESP,2016,15,7859,NA,8011,-152,-1.8973910872550244
Espagne,ESP,2016,16,7589,NA,7769,-180,-2.316900501995109
Espagne,ESP,2016,17,7462,NA,7653,-191,-2.4957532993597282
Espagne,ESP,2016,18,7606,NA,7557,49,0.6484054518989018
Espagne,ESP,2016,19,7374,NA,7579,-205,-2.704842327483837
Espagne,ESP,2016,20,7533,NA,7518,15,0.19952114924181963
Espagne,ESP,2016,21,7304,NA,7482,-178,-2.379043036621224
Espagne,ESP,2016,22,7255,NA,7318,-63,-0.8608909538125171
Espagne,ESP,2016,23,7576,NA,7316,260,3.553854565336249
Espagne,ESP,2016,24,7140,NA,7281,-141,-1.9365471775854965
Espagne,ESP,2016,25,7173,NA,7569,-396,-5.231866825208085
Espagne,ESP,2016,26,7345,NA,7436,-91,-1.2237762237762237
Espagne,ESP,2016,27,7505,NA,7504,1,0.013326226012793176
Espagne,ESP,2016,28,7423,NA,7365,58,0.7875084860828241
Espagne,ESP,2016,29,7377,NA,7279,98,1.346338782799835
Espagne,ESP,2016,30,7295,NA,7255,40,0.5513439007580978
Espagne,ESP,2016,31,7425,NA,7470,-45,-0.6024096385542169
Espagne,ESP,2016,32,7233,NA,7434,-201,-2.7037933817594837
Espagne,ESP,2016,33,7102,NA,7133,-31,-0.43459974765175946
Espagne,ESP,2016,34,7184,NA,7082,102,1.4402711098559728
Espagne,ESP,2016,35,7100,NA,6984,116,1.6609392898052693
Espagne,ESP,2016,36,7203,NA,6920,283,4.089595375722544
Espagne,ESP,2016,37,6641,NA,6783,-142,-2.0934689665339823
Espagne,ESP,2016,38,6956,NA,7048,-92,-1.3053348467650396
Espagne,ESP,2016,39,7036,NA,7163,-127,-1.7730001396063102
Espagne,ESP,2016,40,7072,NA,7158,-86,-1.2014529198100028
Espagne,ESP,2016,41,7036,NA,7251,-215,-2.9651082609295267
Espagne,ESP,2016,42,7185,NA,7305,-120,-1.642710472279261
Espagne,ESP,2016,43,7512,NA,7416,96,1.2944983818770228
Espagne,ESP,2016,44,7244,NA,7554,-310,-4.103786073603389
Espagne,ESP,2016,45,7775,NA,7770,5,0.06435006435006435
Espagne,ESP,2016,46,8076,NA,8038,38,0.4727544165215228
Espagne,ESP,2016,47,8090,NA,8101,-11,-0.13578570546846067
Espagne,ESP,2016,48,8321,NA,8198,123,1.5003659429129057
Espagne,ESP,2016,49,8124,NA,8184,-60,-0.7331378299120235
Espagne,ESP,2016,50,8612,NA,8606,6,0.06971880083662561
Espagne,ESP,2016,51,8980,NA,8826,154,1.7448447767958304
Espagne,ESP,2016,52,9855,NA,9258,597,6.44847699287103
Espagne,ESP,2017,1,10726,NA,9929,797,8.026991640648605
Espagne,ESP,2017,2,11414,NA,10252,1162,11.334373780725713
Espagne,ESP,2017,3,11334,NA,10395,939,9.033189033189034
Espagne,ESP,2017,4,11068,NA,10006,1062,10.613631820907456
Espagne,ESP,2017,5,10636,NA,9738,898,9.221606079277059
Espagne,ESP,2017,6,9660,NA,9477,183,1.9309908198797088
Espagne,ESP,2017,7,9017,NA,9240,-223,-2.4134199134199132
Espagne,ESP,2017,8,8670,NA,9052,-382,-4.220061864781264
Espagne,ESP,2017,9,8371,NA,8884,-513,-5.774425934263845
Espagne,ESP,2017,10,8213,NA,8664,-451,-5.20544783010157
Espagne,ESP,2017,11,7906,NA,8445,-539,-6.382474837181765
Espagne,ESP,2017,12,7875,NA,8201,-326,-3.9751249847579566
Espagne,ESP,2017,13,7827,NA,8250,-423,-5.127272727272728
Espagne,ESP,2017,14,7814,NA,8077,-263,-3.2561594651479506
Espagne,ESP,2017,15,7800,NA,8011,-211,-2.6338784171763825
Espagne,ESP,2017,16,7574,NA,7769,-195,-2.5099755438280344
Espagne,ESP,2017,17,7661,NA,7653,8,0.10453416960669018
Espagne,ESP,2017,18,7520,NA,7557,-37,-0.4896122800052931
Espagne,ESP,2017,19,7622,NA,7579,43,0.567357171130756
Espagne,ESP,2017,20,7494,NA,7518,-24,-0.3192338387869114
Espagne,ESP,2017,21,7666,NA,7482,184,2.4592354985298046
Espagne,ESP,2017,22,7092,NA,7318,-226,-3.08827548510522
Espagne,ESP,2017,23,7067,NA,7316,-249,-3.4034991798797156
Espagne,ESP,2017,24,7819,NA,7281,538,7.389094904546079
Espagne,ESP,2017,25,7991,NA,7569,422,5.575373232923768
Espagne,ESP,2017,26,7137,NA,7436,-299,-4.020979020979021
Espagne,ESP,2017,27,7156,NA,7504,-348,-4.637526652452026
Espagne,ESP,2017,28,7214,NA,7365,-151,-2.0502376103190767
Espagne,ESP,2017,29,7259,NA,7279,-20,-0.27476301689792554
Espagne,ESP,2017,30,7110,NA,7255,-145,-1.9986216402481045
Espagne,ESP,2017,31,7596,NA,7470,126,1.6867469879518073
Espagne,ESP,2017,32,7186,NA,7434,-248,-3.336023675006726
Espagne,ESP,2017,33,7118,NA,7133,-15,-0.2102902004766578
Espagne,ESP,2017,34,7219,NA,7082,137,1.9344817848065516
Espagne,ESP,2017,35,7013,NA,6984,29,0.4152348224513173
Espagne,ESP,2017,36,6680,NA,6920,-240,-3.4682080924855487
Espagne,ESP,2017,37,6730,NA,6783,-53,-0.7813651776500073
Espagne,ESP,2017,38,7091,NA,7048,43,0.6101021566401816
Espagne,ESP,2017,39,7367,NA,7163,204,2.847968728186514
Espagne,ESP,2017,40,7388,NA,7158,230,3.213188041352333
Espagne,ESP,2017,41,7234,NA,7251,-17,-0.234450420631637
Espagne,ESP,2017,42,7392,NA,7305,87,1.190965092402464
Espagne,ESP,2017,43,7308,NA,7416,-108,-1.4563106796116505
Espagne,ESP,2017,44,7511,NA,7554,-43,-0.5692348424675668
Espagne,ESP,2017,45,7632,NA,7770,-138,-1.7760617760617758
Espagne,ESP,2017,46,8063,NA,8038,25,0.31102264244837025
Espagne,ESP,2017,47,8169,NA,8101,68,0.8394025428959389
Espagne,ESP,2017,48,8257,NA,8198,59,0.7196877287143206
Espagne,ESP,2017,49,8620,NA,8184,436,5.327468230694037
Espagne,ESP,2017,50,9262,NA,8606,656,7.622588891471067
Espagne,ESP,2017,51,9628,NA,8826,802,9.08678903240426
Espagne,ESP,2017,52,10412,NA,9258,1154,12.464895225750702
Espagne,ESP,2018,1,11204,NA,9929,1275,12.841172323496828
Espagne,ESP,2018,2,10905,NA,10252,653,6.369488880218493
Espagne,ESP,2018,3,10981,NA,10395,586,5.637325637325637
Espagne,ESP,2018,4,10324,NA,10006,318,3.1780931441135323
Espagne,ESP,2018,5,9893,NA,9738,155,1.5917026083384678
Espagne,ESP,2018,6,10015,NA,9477,538,5.6769019731982695
Espagne,ESP,2018,7,10105,NA,9240,865,9.36147186147186
Espagne,ESP,2018,8,9656,NA,9052,604,6.672558550596554
Espagne,ESP,2018,9,9599,NA,8884,715,8.04817649707339
Espagne,ESP,2018,10,9203,NA,8664,539,6.221144967682364
Espagne,ESP,2018,11,8862,NA,8445,417,4.9378330373001775
Espagne,ESP,2018,12,8616,NA,8201,415,5.060358492866723
Espagne,ESP,2018,13,8628,NA,8250,378,4.581818181818182
Espagne,ESP,2018,14,8414,NA,8077,337,4.172341215797945
Espagne,ESP,2018,15,8335,NA,8011,324,4.044438896517288
Espagne,ESP,2018,16,8112,NA,7769,343,4.414982623246235
Espagne,ESP,2018,17,7735,NA,7653,82,1.0714752384685744
Espagne,ESP,2018,18,7359,NA,7557,-198,-2.6200873362445414
Espagne,ESP,2018,19,7595,NA,7579,16,0.2111096450719092
Espagne,ESP,2018,20,7511,NA,7518,-7,-0.0931098696461825
Espagne,ESP,2018,21,7527,NA,7482,45,0.6014434643143545
Espagne,ESP,2018,22,7306,NA,7318,-12,-0.16397922929762232
Espagne,ESP,2018,23,7109,NA,7316,-207,-2.8294149808638602
Espagne,ESP,2018,24,7154,NA,7281,-127,-1.7442658975415464
Espagne,ESP,2018,25,7713,NA,7569,144,1.9024970273483945
Espagne,ESP,2018,26,7698,NA,7436,262,3.523399677245831
Espagne,ESP,2018,27,7305,NA,7504,-199,-2.651918976545842
Espagne,ESP,2018,28,7366,NA,7365,1,0.013577732518669382
Espagne,ESP,2018,29,7186,NA,7279,-93,-1.2776480285753538
Espagne,ESP,2018,30,7155,NA,7255,-100,-1.3783597518952446
Espagne,ESP,2018,31,7731,NA,7470,261,3.493975903614458
Espagne,ESP,2018,32,8003,NA,7434,569,7.654022060801721
Espagne,ESP,2018,33,7194,NA,7133,61,0.855180148605075
Espagne,ESP,2018,34,7015,NA,7082,-67,-0.9460604349053939
Espagne,ESP,2018,35,6927,NA,6984,-57,-0.816151202749141
Espagne,ESP,2018,36,6906,NA,6920,-14,-0.20231213872832368
Espagne,ESP,2018,37,6834,NA,6783,51,0.7518796992481203
Espagne,ESP,2018,38,7153,NA,7048,105,1.4897843359818388
Espagne,ESP,2018,39,7230,NA,7163,67,0.9353622783749826
Espagne,ESP,2018,40,7210,NA,7158,52,0.726459905001397
Espagne,ESP,2018,41,7437,NA,7251,186,2.5651634257343816
Espagne,ESP,2018,42,7350,NA,7305,45,0.6160164271047228
Espagne,ESP,2018,43,7327,NA,7416,-89,-1.2001078748651564
Espagne,ESP,2018,44,7794,NA,7554,240,3.177124702144559
Espagne,ESP,2018,45,8012,NA,7770,242,3.1145431145431144
Espagne,ESP,2018,46,7999,NA,8038,-39,-0.4851953222194576
Espagne,ESP,2018,47,7932,NA,8101,-169,-2.0861622021972597
Espagne,ESP,2018,48,7929,NA,8198,-269,-3.281288119053428
Espagne,ESP,2018,49,8051,NA,8184,-133,-1.6251221896383186
Espagne,ESP,2018,50,8312,NA,8606,-294,-3.4162212409946546
Espagne,ESP,2018,51,8427,NA,8826,-399,-4.520734194425561
Espagne,ESP,2018,52,8650,NA,9258,-608,-6.567293151868654
Espagne,ESP,2019,1,9127,NA,9929,-802,-8.077349179172122
Espagne,ESP,2019,2,10019,NA,10252,-233,-2.272727272727273
Espagne,ESP,2019,3,10473,NA,10395,78,0.7503607503607503
Espagne,ESP,2019,4,10141,NA,10006,135,1.3491904857085748
Espagne,ESP,2019,5,9964,NA,9738,226,2.320805093448347
Espagne,ESP,2019,6,9676,NA,9477,199,2.099820618339137
Espagne,ESP,2019,7,9357,NA,9240,117,1.2662337662337664
Espagne,ESP,2019,8,9210,NA,9052,158,1.7454706142288996
Espagne,ESP,2019,9,8919,NA,8884,35,0.3939666816749212
Espagne,ESP,2019,10,8588,NA,8664,-76,-0.8771929824561403
Espagne,ESP,2019,11,8202,NA,8445,-243,-2.8774422735346357
Espagne,ESP,2019,12,8022,NA,8201,-179,-2.1826606511401048
Espagne,ESP,2019,13,8169,NA,8250,-81,-0.9818181818181818
Espagne,ESP,2019,14,8081,NA,8077,4,0.04952333787297264
Espagne,ESP,2019,15,8049,NA,8011,38,0.4743477718137561
Espagne,ESP,2019,16,7802,NA,7769,33,0.42476509203243656
Espagne,ESP,2019,17,7754,NA,7653,101,1.3197438912844635
Espagne,ESP,2019,18,7742,NA,7557,185,2.4480614000264653
Espagne,ESP,2019,19,7726,NA,7579,147,1.939569864098166
Espagne,ESP,2019,20,7535,NA,7518,17,0.2261239691407289
Espagne,ESP,2019,21,7429,NA,7482,-53,-0.7083667468591286
Espagne,ESP,2019,22,7619,NA,7318,301,4.11314566821536
Espagne,ESP,2019,23,7512,NA,7316,196,2.6790595954073266
Espagne,ESP,2019,24,7010,NA,7281,-271,-3.7220162065650317
Espagne,ESP,2019,25,7399,NA,7569,-170,-2.246003435064077
Espagne,ESP,2019,26,7566,NA,7436,130,1.7482517482517483
Espagne,ESP,2019,27,8048,NA,7504,544,7.249466950959488
Espagne,ESP,2019,28,7457,NA,7365,92,1.2491513917175832
Espagne,ESP,2019,29,7293,NA,7279,14,0.19233411182854787
Espagne,ESP,2019,30,7461,NA,7255,206,2.839421088904204
Espagne,ESP,2019,31,7128,NA,7470,-342,-4.578313253012048
Espagne,ESP,2019,32,7313,NA,7434,-121,-1.627656712402475
Espagne,ESP,2019,33,7117,NA,7133,-16,-0.22430954717510163
Espagne,ESP,2019,34,6908,NA,7082,-174,-2.4569330697543066
Espagne,ESP,2019,35,6894,NA,6984,-90,-1.2886597938144329
Espagne,ESP,2019,36,6890,NA,6920,-30,-0.4335260115606936
Espagne,ESP,2019,37,6928,NA,6783,145,2.1376971841368126
Espagne,ESP,2019,38,6994,NA,7048,-54,-0.7661748013620885
Espagne,ESP,2019,39,7019,NA,7163,-144,-2.010330866955186
Espagne,ESP,2019,40,6963,NA,7158,-195,-2.724224643755239
Espagne,ESP,2019,41,7297,NA,7251,46,0.6343952558267825
Espagne,ESP,2019,42,7292,NA,7305,-13,-0.1779603011635866
Espagne,ESP,2019,43,7516,NA,7416,100,1.348435814455232
Espagne,ESP,2019,44,7668,NA,7554,114,1.5091342335186657
Espagne,ESP,2019,45,7661,NA,7770,-109,-1.4028314028314028
Espagne,ESP,2019,46,8016,NA,8038,-22,-0.2736999253545658
Espagne,ESP,2019,47,8213,NA,8101,112,1.3825453647697816
Espagne,ESP,2019,48,8287,NA,8198,89,1.0856306416199073
Espagne,ESP,2019,49,7942,NA,8184,-242,-2.956989247311828
Espagne,ESP,2019,50,8239,NA,8606,-367,-4.2644666511736
Espagne,ESP,2019,51,8269,NA,8826,-557,-6.31089961477453
Espagne,ESP,2019,52,8113,NA,9258,-1145,-12.367682004752647
Espagne,ESP,2020,1,8896,0,9929,-1033,-10.403867458958606
Espagne,ESP,2020,2,9612,0,10252,-640,-6.2426843542723365
Espagne,ESP,2020,3,10102,0,10395,-293,-2.8186628186628186
Espagne,ESP,2020,4,9604,0,10006,-402,-4.017589446332201
Espagne,ESP,2020,5,9636,0,9738,-102,-1.0474430067775724
Espagne,ESP,2020,6,9392,0,9477,-85,-0.8969083043157118
Espagne,ESP,2020,7,8976,0,9240,-264,-2.857142857142857
Espagne,ESP,2020,8,8500,0,9052,-552,-6.0980998674326115
Espagne,ESP,2020,9,7989,0,8884,-895,-10.074290859972985
Espagne,ESP,2020,10,8640,28,8664,-24,-0.2770083102493075
Espagne,ESP,2020,11,9277,281,8445,832,9.851983422143281
Espagne,ESP,2020,12,12648,1873,8201,4447,54.22509450067064
Espagne,ESP,2020,13,19166,5158,8250,10916,132.3151515151515
Espagne,ESP,2020,14,20601,5715,8077,12524,155.05757088027735
Espagne,ESP,2020,15,17205,4434,8011,9194,114.76719510672825
Espagne,ESP,2020,16,13087,3793,7769,5318,68.45153816449994
Espagne,ESP,2020,17,10292,2540,7653,2639,34.48320919900693
Espagne,ESP,2020,18,8797,1791,7557,1240,16.408627762339552
Espagne,ESP,2020,19,8533,1307,7579,954,12.587412587412588
Espagne,ESP,2020,20,7503,858,7518,-15,-0.19952114924181963
Espagne,ESP,2020,21,7474,-661,7482,-8,-0.10692328254477412
Estonie,EST,2016,1,322,NA,341,-19,-5.571847507331378
Estonie,EST,2016,2,334,NA,346,-12,-3.4682080924855487
Estonie,EST,2016,3,301,NA,340,-39,-11.470588235294118
Estonie,EST,2016,4,335,NA,339,-4,-1.1799410029498525
Estonie,EST,2016,5,319,NA,342,-23,-6.725146198830409
Estonie,EST,2016,6,353,NA,343,10,2.9154518950437316
Estonie,EST,2016,7,276,NA,321,-45,-14.018691588785046
Estonie,EST,2016,8,313,NA,340,-27,-7.941176470588235
Estonie,EST,2016,9,317,NA,336,-19,-5.654761904761905
Estonie,EST,2016,10,293,NA,329,-36,-10.94224924012158
Estonie,EST,2016,11,303,NA,319,-16,-5.015673981191222
Estonie,EST,2016,12,263,NA,307,-44,-14.332247557003258
Estonie,EST,2016,13,323,NA,317,6,1.8927444794952681
Estonie,EST,2016,14,312,NA,298,14,4.697986577181208
Estonie,EST,2016,15,307,NA,302,5,1.6556291390728477
Estonie,EST,2016,16,298,NA,300,-2,-0.6666666666666667
Estonie,EST,2016,17,295,NA,281,14,4.98220640569395
Estonie,EST,2016,18,304,NA,296,8,2.7027027027027026
Estonie,EST,2016,19,299,NA,290,9,3.103448275862069
Estonie,EST,2016,20,288,NA,298,-10,-3.3557046979865772
Estonie,EST,2016,21,276,NA,288,-12,-4.166666666666666
Estonie,EST,2016,22,277,NA,272,5,1.8382352941176472
Estonie,EST,2016,23,258,NA,277,-19,-6.859205776173286
Estonie,EST,2016,24,276,NA,269,7,2.6022304832713754
Estonie,EST,2016,25,270,NA,269,1,0.37174721189591076
Estonie,EST,2016,26,263,NA,269,-6,-2.2304832713754648
Estonie,EST,2016,27,251,NA,258,-7,-2.7131782945736433
Estonie,EST,2016,28,270,NA,269,1,0.37174721189591076
Estonie,EST,2016,29,276,NA,278,-2,-0.7194244604316548
Estonie,EST,2016,30,264,NA,291,-27,-9.278350515463918
Estonie,EST,2016,31,232,NA,270,-38,-14.074074074074074
Estonie,EST,2016,32,280,NA,289,-9,-3.1141868512110724
Estonie,EST,2016,33,285,NA,276,9,3.260869565217391
Estonie,EST,2016,34,278,NA,265,13,4.905660377358491
Estonie,EST,2016,35,271,NA,276,-5,-1.8115942028985508
Estonie,EST,2016,36,283,NA,270,13,4.814814814814815
Estonie,EST,2016,37,278,NA,266,12,4.511278195488721
Estonie,EST,2016,38,295,NA,281,14,4.98220640569395
Estonie,EST,2016,39,305,NA,285,20,7.017543859649122
Estonie,EST,2016,40,282,NA,283,-1,-0.35335689045936397
Estonie,EST,2016,41,284,NA,278,6,2.158273381294964
Estonie,EST,2016,42,313,NA,292,21,7.191780821917808
Estonie,EST,2016,43,313,NA,300,13,4.333333333333334
Estonie,EST,2016,44,303,NA,300,3,1
Estonie,EST,2016,45,330,NA,280,50,17.857142857142858
Estonie,EST,2016,46,299,NA,292,7,2.3972602739726026
Estonie,EST,2016,47,292,NA,287,5,1.7421602787456445
Estonie,EST,2016,48,284,NA,296,-12,-4.054054054054054
Estonie,EST,2016,49,286,NA,306,-20,-6.535947712418301
Estonie,EST,2016,50,312,NA,300,12,4
Estonie,EST,2016,51,309,NA,308,1,0.3246753246753247
Estonie,EST,2016,52,364,NA,326,38,11.65644171779141
Estonie,EST,2017,1,364,NA,341,23,6.744868035190615
Estonie,EST,2017,2,393,NA,346,47,13.583815028901732
Estonie,EST,2017,3,386,NA,340,46,13.529411764705882
Estonie,EST,2017,4,360,NA,339,21,6.1946902654867255
Estonie,EST,2017,5,392,NA,342,50,14.619883040935672
Estonie,EST,2017,6,351,NA,343,8,2.3323615160349855
Estonie,EST,2017,7,344,NA,321,23,7.165109034267912
Estonie,EST,2017,8,337,NA,340,-3,-0.8823529411764706
Estonie,EST,2017,9,304,NA,336,-32,-9.523809523809524
Estonie,EST,2017,10,328,NA,329,-1,-0.303951367781155
Estonie,EST,2017,11,296,NA,319,-23,-7.210031347962382
Estonie,EST,2017,12,304,NA,307,-3,-0.9771986970684038
Estonie,EST,2017,13,322,NA,317,5,1.5772870662460567
Estonie,EST,2017,14,286,NA,298,-12,-4.026845637583892
Estonie,EST,2017,15,293,NA,302,-9,-2.980132450331126
Estonie,EST,2017,16,285,NA,300,-15,-5
Estonie,EST,2017,17,267,NA,281,-14,-4.98220640569395
Estonie,EST,2017,18,308,NA,296,12,4.054054054054054
Estonie,EST,2017,19,319,NA,290,29,10
Estonie,EST,2017,20,292,NA,298,-6,-2.013422818791946
Estonie,EST,2017,21,290,NA,288,2,0.6944444444444444
Estonie,EST,2017,22,268,NA,272,-4,-1.4705882352941175
Estonie,EST,2017,23,293,NA,277,16,5.776173285198556
Estonie,EST,2017,24,262,NA,269,-7,-2.6022304832713754
Estonie,EST,2017,25,247,NA,269,-22,-8.178438661710038
Estonie,EST,2017,26,272,NA,269,3,1.1152416356877324
Estonie,EST,2017,27,290,NA,258,32,12.4031007751938
Estonie,EST,2017,28,249,NA,269,-20,-7.434944237918216
Estonie,EST,2017,29,242,NA,278,-36,-12.949640287769784
Estonie,EST,2017,30,296,NA,291,5,1.718213058419244
Estonie,EST,2017,31,272,NA,270,2,0.7407407407407408
Estonie,EST,2017,32,304,NA,289,15,5.190311418685121
Estonie,EST,2017,33,260,NA,276,-16,-5.797101449275362
Estonie,EST,2017,34,270,NA,265,5,1.8867924528301887
Estonie,EST,2017,35,305,NA,276,29,10.507246376811594
Estonie,EST,2017,36,259,NA,270,-11,-4.074074074074074
Estonie,EST,2017,37,265,NA,266,-1,-0.37593984962406013
Estonie,EST,2017,38,267,NA,281,-14,-4.98220640569395
Estonie,EST,2017,39,271,NA,285,-14,-4.912280701754386
Estonie,EST,2017,40,273,NA,283,-10,-3.53356890459364
Estonie,EST,2017,41,269,NA,278,-9,-3.237410071942446
Estonie,EST,2017,42,285,NA,292,-7,-2.3972602739726026
Estonie,EST,2017,43,291,NA,300,-9,-3
Estonie,EST,2017,44,324,NA,300,24,8
Estonie,EST,2017,45,262,NA,280,-18,-6.428571428571428
Estonie,EST,2017,46,299,NA,292,7,2.3972602739726026
Estonie,EST,2017,47,267,NA,287,-20,-6.968641114982578
Estonie,EST,2017,48,324,NA,296,28,9.45945945945946
Estonie,EST,2017,49,294,NA,306,-12,-3.9215686274509802
Estonie,EST,2017,50,264,NA,300,-36,-12
Estonie,EST,2017,51,301,NA,308,-7,-2.272727272727273
Estonie,EST,2017,52,310,NA,326,-16,-4.9079754601226995
Estonie,EST,2018,1,328,NA,341,-13,-3.812316715542522
Estonie,EST,2018,2,319,NA,346,-27,-7.803468208092486
Estonie,EST,2018,3,290,NA,340,-50,-14.705882352941178
Estonie,EST,2018,4,338,NA,339,-1,-0.2949852507374631
Estonie,EST,2018,5,333,NA,342,-9,-2.631578947368421
Estonie,EST,2018,6,343,NA,343,0,0
Estonie,EST,2018,7,347,NA,321,26,8.09968847352025
Estonie,EST,2018,8,389,NA,340,49,14.411764705882351
Estonie,EST,2018,9,391,NA,336,55,16.36904761904762
Estonie,EST,2018,10,391,NA,329,62,18.84498480243161
Estonie,EST,2018,11,384,NA,319,65,20.37617554858934
Estonie,EST,2018,12,361,NA,307,54,17.58957654723127
Estonie,EST,2018,13,326,NA,317,9,2.8391167192429023
Estonie,EST,2018,14,337,NA,298,39,13.087248322147651
Estonie,EST,2018,15,319,NA,302,17,5.629139072847682
Estonie,EST,2018,16,318,NA,300,18,6
Estonie,EST,2018,17,276,NA,281,-5,-1.7793594306049825
Estonie,EST,2018,18,269,NA,296,-27,-9.121621621621621
Estonie,EST,2018,19,268,NA,290,-22,-7.586206896551724
Estonie,EST,2018,20,300,NA,298,2,0.6711409395973155
Estonie,EST,2018,21,281,NA,288,-7,-2.430555555555556
Estonie,EST,2018,22,266,NA,272,-6,-2.2058823529411766
Estonie,EST,2018,23,262,NA,277,-15,-5.415162454873646
Estonie,EST,2018,24,282,NA,269,13,4.83271375464684
Estonie,EST,2018,25,277,NA,269,8,2.973977695167286
Estonie,EST,2018,26,261,NA,269,-8,-2.973977695167286
Estonie,EST,2018,27,230,NA,258,-28,-10.852713178294573
Estonie,EST,2018,28,280,NA,269,11,4.089219330855019
Estonie,EST,2018,29,310,NA,278,32,11.510791366906476
Estonie,EST,2018,30,291,NA,291,0,0
Estonie,EST,2018,31,321,NA,270,51,18.88888888888889
Estonie,EST,2018,32,302,NA,289,13,4.498269896193772
Estonie,EST,2018,33,234,NA,276,-42,-15.217391304347828
Estonie,EST,2018,34,261,NA,265,-4,-1.509433962264151
Estonie,EST,2018,35,255,NA,276,-21,-7.608695652173914
Estonie,EST,2018,36,278,NA,270,8,2.9629629629629632
Estonie,EST,2018,37,265,NA,266,-1,-0.37593984962406013
Estonie,EST,2018,38,284,NA,281,3,1.0676156583629894
Estonie,EST,2018,39,283,NA,285,-2,-0.7017543859649122
Estonie,EST,2018,40,273,NA,283,-10,-3.53356890459364
Estonie,EST,2018,41,301,NA,278,23,8.273381294964029
Estonie,EST,2018,42,282,NA,292,-10,-3.4246575342465753
Estonie,EST,2018,43,299,NA,300,-1,-0.33333333333333337
Estonie,EST,2018,44,282,NA,300,-18,-6
Estonie,EST,2018,45,259,NA,280,-21,-7.5
Estonie,EST,2018,46,284,NA,292,-8,-2.73972602739726
Estonie,EST,2018,47,289,NA,287,2,0.6968641114982579
Estonie,EST,2018,48,283,NA,296,-13,-4.391891891891892
Estonie,EST,2018,49,316,NA,306,10,3.2679738562091507
Estonie,EST,2018,50,319,NA,300,19,6.333333333333334
Estonie,EST,2018,51,318,NA,308,10,3.2467532467532463
Estonie,EST,2018,52,329,NA,326,3,0.9202453987730062
Estonie,EST,2019,1,351,NA,341,10,2.932551319648094
Estonie,EST,2019,2,338,NA,346,-8,-2.312138728323699
Estonie,EST,2019,3,383,NA,340,43,12.647058823529411
Estonie,EST,2019,4,324,NA,339,-15,-4.424778761061947
Estonie,EST,2019,5,325,NA,342,-17,-4.970760233918129
Estonie,EST,2019,6,325,NA,343,-18,-5.247813411078718
Estonie,EST,2019,7,317,NA,321,-4,-1.2461059190031152
Estonie,EST,2019,8,322,NA,340,-18,-5.294117647058823
Estonie,EST,2019,9,331,NA,336,-5,-1.488095238095238
Estonie,EST,2019,10,305,NA,329,-24,-7.29483282674772
Estonie,EST,2019,11,294,NA,319,-25,-7.836990595611286
Estonie,EST,2019,12,300,NA,307,-7,-2.2801302931596092
Estonie,EST,2019,13,296,NA,317,-21,-6.624605678233439
Estonie,EST,2019,14,257,NA,298,-41,-13.758389261744966
Estonie,EST,2019,15,290,NA,302,-12,-3.9735099337748347
Estonie,EST,2019,16,299,NA,300,-1,-0.33333333333333337
Estonie,EST,2019,17,286,NA,281,5,1.7793594306049825
Estonie,EST,2019,18,301,NA,296,5,1.6891891891891893
Estonie,EST,2019,19,274,NA,290,-16,-5.517241379310345
Estonie,EST,2019,20,313,NA,298,15,5.033557046979865
Estonie,EST,2019,21,303,NA,288,15,5.208333333333334
Estonie,EST,2019,22,276,NA,272,4,1.4705882352941175
Estonie,EST,2019,23,296,NA,277,19,6.859205776173286
Estonie,EST,2019,24,257,NA,269,-12,-4.4609665427509295
Estonie,EST,2019,25,281,NA,269,12,4.4609665427509295
Estonie,EST,2019,26,279,NA,269,10,3.717472118959108
Estonie,EST,2019,27,263,NA,258,5,1.937984496124031
Estonie,EST,2019,28,278,NA,269,9,3.3457249070631967
Estonie,EST,2019,29,286,NA,278,8,2.877697841726619
Estonie,EST,2019,30,314,NA,291,23,7.903780068728522
Estonie,EST,2019,31,256,NA,270,-14,-5.185185185185185
Estonie,EST,2019,32,269,NA,289,-20,-6.920415224913495
Estonie,EST,2019,33,323,NA,276,47,17.02898550724638
Estonie,EST,2019,34,251,NA,265,-14,-5.283018867924529
Estonie,EST,2019,35,271,NA,276,-5,-1.8115942028985508
Estonie,EST,2019,36,261,NA,270,-9,-3.3333333333333335
Estonie,EST,2019,37,254,NA,266,-12,-4.511278195488721
Estonie,EST,2019,38,277,NA,281,-4,-1.4234875444839856
Estonie,EST,2019,39,282,NA,285,-3,-1.0526315789473684
Estonie,EST,2019,40,305,NA,283,22,7.773851590106007
Estonie,EST,2019,41,257,NA,278,-21,-7.553956834532374
Estonie,EST,2019,42,286,NA,292,-6,-2.054794520547945
Estonie,EST,2019,43,296,NA,300,-4,-1.3333333333333335
Estonie,EST,2019,44,293,NA,300,-7,-2.3333333333333335
Estonie,EST,2019,45,271,NA,280,-9,-3.214285714285714
Estonie,EST,2019,46,288,NA,292,-4,-1.36986301369863
Estonie,EST,2019,47,299,NA,287,12,4.181184668989547
Estonie,EST,2019,48,291,NA,296,-5,-1.6891891891891893
Estonie,EST,2019,49,327,NA,306,21,6.862745098039216
Estonie,EST,2019,50,304,NA,300,4,1.3333333333333335
Estonie,EST,2019,51,305,NA,308,-3,-0.974025974025974
Estonie,EST,2019,52,302,NA,326,-24,-7.361963190184049
Estonie,EST,2020,1,294,0,341,-47,-13.78299120234604
Estonie,EST,2020,2,330,0,346,-16,-4.624277456647398
Estonie,EST,2020,3,316,0,340,-24,-7.0588235294117645
Estonie,EST,2020,4,300,0,339,-39,-11.504424778761061
Estonie,EST,2020,5,308,0,342,-34,-9.941520467836257
Estonie,EST,2020,6,274,0,343,-69,-20.11661807580175
Estonie,EST,2020,7,322,0,321,1,0.3115264797507788
Estonie,EST,2020,8,334,0,340,-6,-1.7647058823529411
Estonie,EST,2020,9,313,0,336,-23,-6.845238095238096
Estonie,EST,2020,10,293,0,329,-36,-10.94224924012158
Estonie,EST,2020,11,337,0,319,18,5.6426332288401255
Estonie,EST,2020,12,309,0,307,2,0.6514657980456027
Estonie,EST,2020,13,326,3,317,9,2.8391167192429023
Estonie,EST,2020,14,310,16,298,12,4.026845637583892
Estonie,EST,2020,15,312,9,302,10,3.3112582781456954
Estonie,EST,2020,16,305,12,300,5,1.6666666666666667
Estonie,EST,2020,17,323,10,281,42,14.94661921708185
Estonie,EST,2020,18,298,5,296,2,0.6756756756756757
Estonie,EST,2020,19,311,6,290,21,7.241379310344828
Estonie,EST,2020,20,286,3,298,-12,-4.026845637583892
Estonie,EST,2020,21,272,1,288,-16,-5.555555555555555
Estonie,EST,2020,22,294,3,272,22,8.088235294117647
Estonie,EST,2020,23,248,1,277,-29,-10.469314079422382
Finlande,FIN,2016,1,1184,NA,1186,-2,-0.16863406408094433
Finlande,FIN,2016,2,1192,NA,1186,6,0.5059021922428331
Finlande,FIN,2016,3,1249,NA,1178,71,6.027164685908319
Finlande,FIN,2016,4,1186,NA,1149,37,3.2201914708442123
Finlande,FIN,2016,5,1183,NA,1156,27,2.3356401384083045
Finlande,FIN,2016,6,1167,NA,1138,29,2.5483304042179262
Finlande,FIN,2016,7,1047,NA,1100,-53,-4.818181818181818
Finlande,FIN,2016,8,1046,NA,1100,-54,-4.909090909090909
Finlande,FIN,2016,9,1075,NA,1119,-44,-3.932082216264522
Finlande,FIN,2016,10,1023,NA,1095,-72,-6.575342465753424
Finlande,FIN,2016,11,1041,NA,1117,-76,-6.803939122649955
Finlande,FIN,2016,12,1095,NA,1106,-11,-0.9945750452079566
Finlande,FIN,2016,13,1097,NA,1077,20,1.8570102135561743
Finlande,FIN,2016,14,980,NA,1079,-99,-9.175162187210379
Finlande,FIN,2016,15,1010,NA,1040,-30,-2.8846153846153846
Finlande,FIN,2016,16,1060,NA,1062,-2,-0.18832391713747645
Finlande,FIN,2016,17,968,NA,1000,-32,-3.2
Finlande,FIN,2016,18,976,NA,1042,-66,-6.333973128598848
Finlande,FIN,2016,19,947,NA,987,-40,-4.052684903748734
Finlande,FIN,2016,20,963,NA,982,-19,-1.9348268839103868
Finlande,FIN,2016,21,1023,NA,964,59,6.1203319502074685
Finlande,FIN,2016,22,980,NA,951,29,3.0494216614090432
Finlande,FIN,2016,23,913,NA,981,-68,-6.931702344546381
Finlande,FIN,2016,24,947,NA,956,-9,-0.9414225941422595
Finlande,FIN,2016,25,939,NA,962,-23,-2.390852390852391
Finlande,FIN,2016,26,995,NA,957,38,3.9707419017763845
Finlande,FIN,2016,27,874,NA,928,-54,-5.818965517241379
Finlande,FIN,2016,28,940,NA,958,-18,-1.8789144050104383
Finlande,FIN,2016,29,949,NA,974,-25,-2.5667351129363447
Finlande,FIN,2016,30,952,NA,991,-39,-3.9354187689202824
Finlande,FIN,2016,31,902,NA,952,-50,-5.2521008403361344
Finlande,FIN,2016,32,919,NA,938,-19,-2.025586353944563
Finlande,FIN,2016,33,946,NA,949,-3,-0.31612223393045313
Finlande,FIN,2016,34,1006,NA,962,44,4.5738045738045745
Finlande,FIN,2016,35,991,NA,964,27,2.8008298755186725
Finlande,FIN,2016,36,991,NA,980,11,1.1224489795918366
Finlande,FIN,2016,37,922,NA,965,-43,-4.455958549222798
Finlande,FIN,2016,38,1012,NA,989,23,2.3255813953488373
Finlande,FIN,2016,39,983,NA,1004,-21,-2.091633466135458
Finlande,FIN,2016,40,986,NA,1031,-45,-4.364694471387003
Finlande,FIN,2016,41,1074,NA,1033,41,3.969022265246854
Finlande,FIN,2016,42,994,NA,1013,-19,-1.8756169792694966
Finlande,FIN,2016,43,1025,NA,1032,-7,-0.6782945736434108
Finlande,FIN,2016,44,1040,NA,1049,-9,-0.8579599618684461
Finlande,FIN,2016,45,1071,NA,1019,52,5.103042198233562
Finlande,FIN,2016,46,1006,NA,992,14,1.411290322580645
Finlande,FIN,2016,47,1099,NA,1016,83,8.169291338582676
Finlande,FIN,2016,48,1044,NA,1024,20,1.953125
Finlande,FIN,2016,49,1034,NA,1052,-18,-1.7110266159695817
Finlande,FIN,2016,50,1069,NA,1061,8,0.7540056550424128
Finlande,FIN,2016,51,1168,NA,1106,62,5.605786618444846
Finlande,FIN,2016,52,1321,NA,1176,145,12.329931972789115
Finlande,FIN,2017,1,1273,NA,1186,87,7.33558178752108
Finlande,FIN,2017,2,1335,NA,1186,149,12.563237774030354
Finlande,FIN,2017,3,1208,NA,1178,30,2.5466893039049237
Finlande,FIN,2017,4,1145,NA,1149,-4,-0.34812880765883375
Finlande,FIN,2017,5,1116,NA,1156,-40,-3.4602076124567476
Finlande,FIN,2017,6,1106,NA,1138,-32,-2.8119507908611596
Finlande,FIN,2017,7,1122,NA,1100,22,2
Finlande,FIN,2017,8,1124,NA,1100,24,2.181818181818182
Finlande,FIN,2017,9,1083,NA,1119,-36,-3.2171581769436997
Finlande,FIN,2017,10,1048,NA,1095,-47,-4.292237442922374
Finlande,FIN,2017,11,1021,NA,1117,-96,-8.594449418084155
Finlande,FIN,2017,12,1065,NA,1106,-41,-3.7070524412296564
Finlande,FIN,2017,13,985,NA,1077,-92,-8.542246982358403
Finlande,FIN,2017,14,1059,NA,1079,-20,-1.8535681186283595
Finlande,FIN,2017,15,998,NA,1040,-42,-4.038461538461538
Finlande,FIN,2017,16,1055,NA,1062,-7,-0.6591337099811676
Finlande,FIN,2017,17,1006,NA,1000,6,0.6
Finlande,FIN,2017,18,1079,NA,1042,37,3.5508637236084453
Finlande,FIN,2017,19,1049,NA,987,62,6.281661600810537
Finlande,FIN,2017,20,999,NA,982,17,1.7311608961303464
Finlande,FIN,2017,21,995,NA,964,31,3.2157676348547715
Finlande,FIN,2017,22,980,NA,951,29,3.0494216614090432
Finlande,FIN,2017,23,1014,NA,981,33,3.3639143730886847
Finlande,FIN,2017,24,1021,NA,956,65,6.7991631799163175
Finlande,FIN,2017,25,993,NA,962,31,3.2224532224532227
Finlande,FIN,2017,26,993,NA,957,36,3.761755485893417
Finlande,FIN,2017,27,929,NA,928,1,0.10775862068965517
Finlande,FIN,2017,28,921,NA,958,-37,-3.8622129436325676
Finlande,FIN,2017,29,925,NA,974,-49,-5.030800821355236
Finlande,FIN,2017,30,944,NA,991,-47,-4.742684157416751
Finlande,FIN,2017,31,923,NA,952,-29,-3.046218487394958
Finlande,FIN,2017,32,954,NA,938,16,1.7057569296375266
Finlande,FIN,2017,33,943,NA,949,-6,-0.6322444678609063
Finlande,FIN,2017,34,906,NA,962,-56,-5.8212058212058215
Finlande,FIN,2017,35,954,NA,964,-10,-1.0373443983402488
Finlande,FIN,2017,36,1001,NA,980,21,2.142857142857143
Finlande,FIN,2017,37,1040,NA,965,75,7.772020725388601
Finlande,FIN,2017,38,940,NA,989,-49,-4.954499494438827
Finlande,FIN,2017,39,974,NA,1004,-30,-2.9880478087649402
Finlande,FIN,2017,40,1030,NA,1031,-1,-0.09699321047526674
Finlande,FIN,2017,41,964,NA,1033,-69,-6.679574056147144
Finlande,FIN,2017,42,1024,NA,1013,11,1.085883514313919
Finlande,FIN,2017,43,1024,NA,1032,-8,-0.7751937984496124
Finlande,FIN,2017,44,1034,NA,1049,-15,-1.4299332697807436
Finlande,FIN,2017,45,977,NA,1019,-42,-4.121687929342492
Finlande,FIN,2017,46,966,NA,992,-26,-2.620967741935484
Finlande,FIN,2017,47,998,NA,1016,-18,-1.7716535433070866
Finlande,FIN,2017,48,988,NA,1024,-36,-3.515625
Finlande,FIN,2017,49,1014,NA,1052,-38,-3.6121673003802277
Finlande,FIN,2017,50,1056,NA,1061,-5,-0.47125353440150797
Finlande,FIN,2017,51,1112,NA,1106,6,0.5424954792043399
Finlande,FIN,2017,52,1103,NA,1176,-73,-6.207482993197279
Finlande,FIN,2018,1,1072,NA,1186,-114,-9.612141652613827
Finlande,FIN,2018,2,1091,NA,1186,-95,-8.010118043844857
Finlande,FIN,2018,3,1083,NA,1178,-95,-8.064516129032258
Finlande,FIN,2018,4,1131,NA,1149,-18,-1.5665796344647518
Finlande,FIN,2018,5,1186,NA,1156,30,2.5951557093425603
Finlande,FIN,2018,6,1110,NA,1138,-28,-2.460456942003515
Finlande,FIN,2018,7,1143,NA,1100,43,3.909090909090909
Finlande,FIN,2018,8,1173,NA,1100,73,6.636363636363636
Finlande,FIN,2018,9,1247,NA,1119,128,11.438784629133155
Finlande,FIN,2018,10,1223,NA,1095,128,11.689497716894977
Finlande,FIN,2018,11,1251,NA,1117,134,11.996418979409132
Finlande,FIN,2018,12,1216,NA,1106,110,9.945750452079565
Finlande,FIN,2018,13,1154,NA,1077,77,7.149489322191272
Finlande,FIN,2018,14,1243,NA,1079,164,15.19925857275255
Finlande,FIN,2018,15,1096,NA,1040,56,5.384615384615385
Finlande,FIN,2018,16,1110,NA,1062,48,4.519774011299435
Finlande,FIN,2018,17,1027,NA,1000,27,2.7
Finlande,FIN,2018,18,1023,NA,1042,-19,-1.8234165067178503
Finlande,FIN,2018,19,980,NA,987,-7,-0.7092198581560284
Finlande,FIN,2018,20,973,NA,982,-9,-0.9164969450101833
Finlande,FIN,2018,21,909,NA,964,-55,-5.7053941908713695
Finlande,FIN,2018,22,926,NA,951,-25,-2.6288117770767614
Finlande,FIN,2018,23,944,NA,981,-37,-3.771661569826707
Finlande,FIN,2018,24,921,NA,956,-35,-3.6610878661087867
Finlande,FIN,2018,25,954,NA,962,-8,-0.8316008316008316
Finlande,FIN,2018,26,946,NA,957,-11,-1.1494252873563218
Finlande,FIN,2018,27,961,NA,928,33,3.556034482758621
Finlande,FIN,2018,28,986,NA,958,28,2.9227557411273484
Finlande,FIN,2018,29,1060,NA,974,86,8.829568788501026
Finlande,FIN,2018,30,1047,NA,991,56,5.650857719475278
Finlande,FIN,2018,31,1063,NA,952,111,11.659663865546218
Finlande,FIN,2018,32,919,NA,938,-19,-2.025586353944563
Finlande,FIN,2018,33,984,NA,949,35,3.68809272918862
Finlande,FIN,2018,34,943,NA,962,-19,-1.9750519750519753
Finlande,FIN,2018,35,947,NA,964,-17,-1.7634854771784232
Finlande,FIN,2018,36,941,NA,980,-39,-3.9795918367346936
Finlande,FIN,2018,37,907,NA,965,-58,-6.010362694300518
Finlande,FIN,2018,38,997,NA,989,8,0.8088978766430739
Finlande,FIN,2018,39,1012,NA,1004,8,0.796812749003984
Finlande,FIN,2018,40,1059,NA,1031,28,2.7158098933074686
Finlande,FIN,2018,41,1004,NA,1033,-29,-2.8073572120038723
Finlande,FIN,2018,42,982,NA,1013,-31,-3.0602171767028628
Finlande,FIN,2018,43,999,NA,1032,-33,-3.1976744186046515
Finlande,FIN,2018,44,1021,NA,1049,-28,-2.669208770257388
Finlande,FIN,2018,45,1031,NA,1019,12,1.1776251226692835
Finlande,FIN,2018,46,983,NA,992,-9,-0.9072580645161291
Finlande,FIN,2018,47,995,NA,1016,-21,-2.066929133858268
Finlande,FIN,2018,48,1038,NA,1024,14,1.3671875
Finlande,FIN,2018,49,1063,NA,1052,11,1.0456273764258555
Finlande,FIN,2018,50,1065,NA,1061,4,0.3770028275212064
Finlande,FIN,2018,51,1037,NA,1106,-69,-6.23869801084991
Finlande,FIN,2018,52,1193,NA,1176,17,1.445578231292517
Finlande,FIN,2019,1,1213,NA,1186,27,2.2765598650927488
Finlande,FIN,2019,2,1125,NA,1186,-61,-5.143338954468803
Finlande,FIN,2019,3,1171,NA,1178,-7,-0.5942275042444821
Finlande,FIN,2019,4,1134,NA,1149,-15,-1.3054830287206265
Finlande,FIN,2019,5,1141,NA,1156,-15,-1.2975778546712802
Finlande,FIN,2019,6,1170,NA,1138,32,2.8119507908611596
Finlande,FIN,2019,7,1089,NA,1100,-11,-1
Finlande,FIN,2019,8,1058,NA,1100,-42,-3.8181818181818183
Finlande,FIN,2019,9,1070,NA,1119,-49,-4.378909740840036
Finlande,FIN,2019,10,1085,NA,1095,-10,-0.91324200913242
Finlande,FIN,2019,11,1154,NA,1117,37,3.312444046553268
Finlande,FIN,2019,12,1047,NA,1106,-59,-5.334538878842676
Finlande,FIN,2019,13,1072,NA,1077,-5,-0.4642525533890436
Finlande,FIN,2019,14,1033,NA,1079,-46,-4.263206672845228
Finlande,FIN,2019,15,1058,NA,1040,18,1.7307692307692308
Finlande,FIN,2019,16,1024,NA,1062,-38,-3.5781544256120528
Finlande,FIN,2019,17,1001,NA,1000,1,0.1
Finlande,FIN,2019,18,1090,NA,1042,48,4.606525911708253
Finlande,FIN,2019,19,972,NA,987,-15,-1.5197568389057752
Finlande,FIN,2019,20,993,NA,982,11,1.120162932790224
Finlande,FIN,2019,21,927,NA,964,-37,-3.8381742738589213
Finlande,FIN,2019,22,919,NA,951,-32,-3.3648790746582544
Finlande,FIN,2019,23,1053,NA,981,72,7.339449541284404
Finlande,FIN,2019,24,934,NA,956,-22,-2.301255230125523
Finlande,FIN,2019,25,962,NA,962,0,0
Finlande,FIN,2019,26,895,NA,957,-62,-6.478578892371996
Finlande,FIN,2019,27,949,NA,928,21,2.2629310344827585
Finlande,FIN,2019,28,983,NA,958,25,2.6096033402922756
Finlande,FIN,2019,29,962,NA,974,-12,-1.2320328542094456
Finlande,FIN,2019,30,1022,NA,991,31,3.128153380423814
Finlande,FIN,2019,31,922,NA,952,-30,-3.1512605042016806
Finlande,FIN,2019,32,958,NA,938,20,2.1321961620469083
Finlande,FIN,2019,33,923,NA,949,-26,-2.73972602739726
Finlande,FIN,2019,34,992,NA,962,30,3.118503118503119
Finlande,FIN,2019,35,966,NA,964,2,0.2074688796680498
Finlande,FIN,2019,36,986,NA,980,6,0.6122448979591837
Finlande,FIN,2019,37,990,NA,965,25,2.5906735751295336
Finlande,FIN,2019,38,1007,NA,989,18,1.820020222446916
Finlande,FIN,2019,39,1047,NA,1004,43,4.282868525896414
Finlande,FIN,2019,40,1050,NA,1031,19,1.842870999030068
Finlande,FIN,2019,41,1090,NA,1033,57,5.517909002904163
Finlande,FIN,2019,42,1052,NA,1013,39,3.8499506416584404
Finlande,FIN,2019,43,1081,NA,1032,49,4.748062015503876
Finlande,FIN,2019,44,1101,NA,1049,52,4.957102001906578
Finlande,FIN,2019,45,997,NA,1019,-22,-2.1589793915603535
Finlande,FIN,2019,46,1014,NA,992,22,2.217741935483871
Finlande,FIN,2019,47,970,NA,1016,-46,-4.52755905511811
Finlande,FIN,2019,48,1024,NA,1024,0,0
Finlande,FIN,2019,49,1097,NA,1052,45,4.277566539923954
Finlande,FIN,2019,50,1053,NA,1061,-8,-0.7540056550424128
Finlande,FIN,2019,51,1105,NA,1106,-1,-0.09041591320072333
Finlande,FIN,2019,52,1089,NA,1176,-87,-7.3979591836734695
Finlande,FIN,2020,1,1044,0,1186,-142,-11.973018549747048
Finlande,FIN,2020,2,1068,0,1186,-118,-9.949409780775717
Finlande,FIN,2020,3,1057,0,1178,-121,-10.27164685908319
Finlande,FIN,2020,4,1039,0,1149,-110,-9.573542210617928
Finlande,FIN,2020,5,1072,0,1156,-84,-7.26643598615917
Finlande,FIN,2020,6,1114,0,1138,-24,-2.10896309314587
Finlande,FIN,2020,7,1097,0,1100,-3,-0.27272727272727276
Finlande,FIN,2020,8,1088,0,1100,-12,-1.090909090909091
Finlande,FIN,2020,9,1048,0,1119,-71,-6.344950848972298
Finlande,FIN,2020,10,1100,0,1095,5,0.45662100456621
Finlande,FIN,2020,11,1096,0,1117,-21,-1.8800358102059087
Finlande,FIN,2020,12,1117,1,1106,11,0.9945750452079566
Finlande,FIN,2020,13,1104,12,1077,27,2.5069637883008355
Finlande,FIN,2020,14,1102,14,1079,23,2.131603336422614
Finlande,FIN,2020,15,1176,32,1040,136,13.076923076923078
Finlande,FIN,2020,16,1085,39,1062,23,2.1657250470809792
Finlande,FIN,2020,17,1127,95,1000,127,12.7
Finlande,FIN,2020,18,1115,47,1042,73,7.005758157389636
Finlande,FIN,2020,19,1053,31,987,66,6.68693009118541
Finlande,FIN,2020,20,1073,29,982,91,9.266802443991853
Finlande,FIN,2020,21,875,8,964,-89,-9.232365145228217
Finlande,FIN,2020,22,640,12,951,-311,-32.70241850683491
France,FRA,2016,1,12183,NA,13858,-1675,-12.086881223841823
France,FRA,2016,2,12247,NA,13919,-1672,-12.012357209569654
France,FRA,2016,3,12403,NA,13571,-1168,-8.606587576449783
France,FRA,2016,4,12065,NA,13430,-1365,-10.163812360387194
France,FRA,2016,5,11963,NA,13270,-1307,-9.849284099472493
France,FRA,2016,6,12059,NA,13243,-1184,-8.94057237786
France,FRA,2016,7,11846,NA,12858,-1012,-7.870586405350755
France,FRA,2016,8,11753,NA,12775,-1022,-8
France,FRA,2016,9,12252,NA,13012,-760,-5.840762373193975
France,FRA,2016,10,12158,NA,12790,-632,-4.941360437842064
France,FRA,2016,11,12309,NA,12232,77,0.6294964028776978
France,FRA,2016,12,12111,NA,11962,149,1.2456111018224378
France,FRA,2016,13,12212,NA,11880,332,2.7946127946127945
France,FRA,2016,14,11826,NA,11673,153,1.310717039321511
France,FRA,2016,15,11456,NA,11378,78,0.685533485674108
France,FRA,2016,16,10923,NA,11302,-379,-3.35338878074677
France,FRA,2016,17,10963,NA,11190,-227,-2.028596961572833
France,FRA,2016,18,11097,NA,11050,47,0.42533936651583715
France,FRA,2016,19,10931,NA,10929,2,0.018299935950224173
France,FRA,2016,20,10769,NA,10877,-108,-0.9929208421439736
France,FRA,2016,21,10720,NA,10911,-191,-1.750526991109889
France,FRA,2016,22,10266,NA,10519,-253,-2.405171594258009
France,FRA,2016,23,10553,NA,10400,153,1.4711538461538463
France,FRA,2016,24,10154,NA,10326,-172,-1.6656982374588416
France,FRA,2016,25,10650,NA,10734,-84,-0.7825600894354388
France,FRA,2016,26,10310,NA,10693,-383,-3.5817824745160385
France,FRA,2016,27,10712,NA,10886,-174,-1.598383244534264
France,FRA,2016,28,10399,NA,10450,-51,-0.4880382775119617
France,FRA,2016,29,11162,NA,10758,404,3.7553448596393384
France,FRA,2016,30,10116,NA,10836,-720,-6.64451827242525
France,FRA,2016,31,10061,NA,10526,-465,-4.4176325289758696
France,FRA,2016,32,10030,NA,10436,-406,-3.890379455730165
France,FRA,2016,33,10451,NA,10294,157,1.5251602875461434
France,FRA,2016,34,10760,NA,10656,104,0.975975975975976
France,FRA,2016,35,10313,NA,10576,-263,-2.486762481089259
France,FRA,2016,36,10421,NA,10390,31,0.2983638113570741
France,FRA,2016,37,10442,NA,10658,-216,-2.026646650403453
France,FRA,2016,38,10499,NA,10939,-440,-4.022305512386873
France,FRA,2016,39,10733,NA,10919,-186,-1.7034526971334372
France,FRA,2016,40,10906,NA,11156,-250,-2.240946575833632
France,FRA,2016,41,11495,NA,11398,97,0.8510264958764696
France,FRA,2016,42,11607,NA,11278,329,2.9171838978542293
France,FRA,2016,43,11594,NA,11375,219,1.9252747252747255
France,FRA,2016,44,11389,NA,11429,-40,-0.34998687549216906
France,FRA,2016,45,11592,NA,11663,-71,-0.6087627540084026
France,FRA,2016,46,11919,NA,11759,160,1.3606599200612297
France,FRA,2016,47,11632,NA,11886,-254,-2.136967861349487
France,FRA,2016,48,11636,NA,11928,-292,-2.448021462105969
France,FRA,2016,49,12147,NA,12043,104,0.8635721996180354
France,FRA,2016,50,12508,NA,12381,127,1.0257652855181325
France,FRA,2016,51,13474,NA,12821,653,5.09320645815459
France,FRA,2016,52,14659,NA,13246,1413,10.667371281896422
France,FRA,2017,1,15777,NA,13858,1919,13.847597055852216
France,FRA,2017,2,15953,NA,13919,2034,14.613118758531504
France,FRA,2017,3,14956,NA,13571,1385,10.205585439540195
France,FRA,2017,4,15033,NA,13430,1603,11.93596425912137
France,FRA,2017,5,14514,NA,13270,1244,9.374529012810852
France,FRA,2017,6,13650,NA,13243,407,3.0733217548893754
France,FRA,2017,7,12848,NA,12858,-10,-0.07777259293824856
France,FRA,2017,8,12231,NA,12775,-544,-4.258317025440314
France,FRA,2017,9,11960,NA,13012,-1052,-8.08484475868429
France,FRA,2017,10,11699,NA,12790,-1091,-8.530101641907741
France,FRA,2017,11,11254,NA,12232,-978,-7.995421844342708
France,FRA,2017,12,10996,NA,11962,-966,-8.075572646714596
France,FRA,2017,13,11009,NA,11880,-871,-7.331649831649832
France,FRA,2017,14,10880,NA,11673,-793,-6.793454981581427
France,FRA,2017,15,10872,NA,11378,-506,-4.447178766039726
France,FRA,2017,16,10916,NA,11302,-386,-3.4153247212882674
France,FRA,2017,17,11242,NA,11190,52,0.4647006255585344
France,FRA,2017,18,11096,NA,11050,46,0.416289592760181
France,FRA,2017,19,10941,NA,10929,12,0.10979961570134504
France,FRA,2017,20,10865,NA,10877,-12,-0.11032453801599706
France,FRA,2017,21,10846,NA,10911,-65,-0.5957290807442032
France,FRA,2017,22,10375,NA,10519,-144,-1.3689514212377603
France,FRA,2017,23,10086,NA,10400,-314,-3.019230769230769
France,FRA,2017,24,10334,NA,10326,8,0.07747433662599264
France,FRA,2017,25,11076,NA,10734,342,3.186137506987144
France,FRA,2017,26,9926,NA,10693,-767,-7.172916861498177
France,FRA,2017,27,10821,NA,10886,-65,-0.5970971890501562
France,FRA,2017,28,10334,NA,10450,-116,-1.1100478468899522
France,FRA,2017,29,10529,NA,10758,-229,-2.1286484476668526
France,FRA,2017,30,10410,NA,10836,-426,-3.9313399778516054
France,FRA,2017,31,10672,NA,10526,146,1.3870416112483375
France,FRA,2017,32,10133,NA,10436,-303,-2.90341126868532
France,FRA,2017,33,10326,NA,10294,32,0.3108606955508063
France,FRA,2017,34,10644,NA,10656,-12,-0.11261261261261261
France,FRA,2017,35,10558,NA,10576,-18,-0.170196671709531
France,FRA,2017,36,10021,NA,10390,-369,-3.5514918190567855
France,FRA,2017,37,10611,NA,10658,-47,-0.44098329893038096
France,FRA,2017,38,11341,NA,10939,402,3.6749245817716427
France,FRA,2017,39,11476,NA,10919,557,5.10119974356626
France,FRA,2017,40,11220,NA,11156,64,0.5736823234134099
France,FRA,2017,41,11350,NA,11398,-48,-0.42112651342340757
France,FRA,2017,42,11080,NA,11278,-198,-1.7556304309274695
France,FRA,2017,43,11201,NA,11375,-174,-1.5296703296703298
France,FRA,2017,44,11247,NA,11429,-182,-1.5924402834893694
France,FRA,2017,45,11535,NA,11663,-128,-1.0974877818743034
France,FRA,2017,46,11653,NA,11759,-106,-0.9014371970405647
France,FRA,2017,47,11840,NA,11886,-46,-0.38700992764597003
France,FRA,2017,48,12013,NA,11928,85,0.7126089872568746
France,FRA,2017,49,12278,NA,12043,235,1.9513410279830607
France,FRA,2017,50,12832,NA,12381,451,3.6426782973911638
France,FRA,2017,51,12936,NA,12821,115,0.8969659152952187
France,FRA,2017,52,13709,NA,13246,463,3.4953948361769593
France,FRA,2018,1,14389,NA,13858,531,3.8317217491701543
France,FRA,2018,2,13866,NA,13919,-53,-0.3807744809253538
France,FRA,2018,3,13429,NA,13571,-142,-1.0463488320683811
France,FRA,2018,4,12695,NA,13430,-735,-5.472822040208489
France,FRA,2018,5,12409,NA,13270,-861,-6.488319517709118
France,FRA,2018,6,12950,NA,13243,-293,-2.2124896171562334
France,FRA,2018,7,12894,NA,12858,36,0.2799813345776948
France,FRA,2018,8,13383,NA,12775,608,4.759295499021526
France,FRA,2018,9,14473,NA,13012,1461,11.228097141100521
France,FRA,2018,10,14595,NA,12790,1805,14.112587959343237
France,FRA,2018,11,13387,NA,12232,1155,9.442446043165468
France,FRA,2018,12,12932,NA,11962,970,8.109011870924594
France,FRA,2018,13,12718,NA,11880,838,7.053872053872054
France,FRA,2018,14,12263,NA,11673,590,5.05439904052086
France,FRA,2018,15,11930,NA,11378,552,4.85146774477061
France,FRA,2018,16,11822,NA,11302,520,4.60095558308264
France,FRA,2018,17,11061,NA,11190,-129,-1.1528150134048258
France,FRA,2018,18,10915,NA,11050,-135,-1.2217194570135748
France,FRA,2018,19,10577,NA,10929,-352,-3.220788727239455
France,FRA,2018,20,10678,NA,10877,-199,-1.8295485887652845
France,FRA,2018,21,11024,NA,10911,113,1.0356520942168455
France,FRA,2018,22,10738,NA,10519,219,2.081946953132427
France,FRA,2018,23,10372,NA,10400,-28,-0.2692307692307692
France,FRA,2018,24,10246,NA,10326,-80,-0.7747433662599265
France,FRA,2018,25,10454,NA,10734,-280,-2.6085336314514627
France,FRA,2018,26,11136,NA,10693,443,4.142897222481998
France,FRA,2018,27,11011,NA,10886,125,1.1482638250964543
France,FRA,2018,28,10513,NA,10450,63,0.6028708133971292
France,FRA,2018,29,10738,NA,10758,-20,-0.18590816136828406
France,FRA,2018,30,11196,NA,10836,360,3.322259136212625
France,FRA,2018,31,11002,NA,10526,476,4.522135664069922
France,FRA,2018,32,10994,NA,10436,558,5.3468761977769255
France,FRA,2018,33,10163,NA,10294,-131,-1.2725859724111133
France,FRA,2018,34,10618,NA,10656,-38,-0.3566066066066066
France,FRA,2018,35,10363,NA,10576,-213,-2.0139939485627836
France,FRA,2018,36,10754,NA,10390,364,3.503368623676612
France,FRA,2018,37,10785,NA,10658,127,1.1915931694501782
France,FRA,2018,38,10772,NA,10939,-167,-1.5266477740195632
France,FRA,2018,39,10689,NA,10919,-230,-2.10642000183167
France,FRA,2018,40,11310,NA,11156,154,1.3804230907135173
France,FRA,2018,41,11391,NA,11398,-7,-0.06141428320758028
France,FRA,2018,42,11012,NA,11278,-266,-2.358574215286398
France,FRA,2018,43,11258,NA,11375,-117,-1.0285714285714285
France,FRA,2018,44,11436,NA,11429,7,0.06124770321112959
France,FRA,2018,45,11712,NA,11663,49,0.42013204149875677
France,FRA,2018,46,11474,NA,11759,-285,-2.4236754826090654
France,FRA,2018,47,11706,NA,11886,-180,-1.5143866733972742
France,FRA,2018,48,11811,NA,11928,-117,-0.9808853118712274
France,FRA,2018,49,11567,NA,12043,-476,-3.952503529021008
France,FRA,2018,50,11733,NA,12381,-648,-5.2338260237460625
France,FRA,2018,51,12260,NA,12821,-561,-4.375633725918416
France,FRA,2018,52,12182,NA,13246,-1064,-8.032613619205797
France,FRA,2019,1,13082,NA,13858,-776,-5.5996536296723916
France,FRA,2019,2,13609,NA,13919,-310,-2.2271714922048997
France,FRA,2019,3,13496,NA,13571,-75,-0.5526490310220322
France,FRA,2019,4,13927,NA,13430,497,3.700670141474311
France,FRA,2019,5,14196,NA,13270,926,6.978146194423513
France,FRA,2019,6,14313,NA,13243,1070,8.07974024012686
France,FRA,2019,7,13842,NA,12858,984,7.652823145123658
France,FRA,2019,8,13734,NA,12775,959,7.506849315068494
France,FRA,2019,9,13363,NA,13012,351,2.6975099907777436
France,FRA,2019,10,12707,NA,12790,-83,-0.6489444878811572
France,FRA,2019,11,11976,NA,12232,-256,-2.092871157619359
France,FRA,2019,12,11811,NA,11962,-151,-1.262330713927437
France,FRA,2019,13,11579,NA,11880,-301,-2.5336700336700337
France,FRA,2019,14,11724,NA,11673,51,0.43690567977383704
France,FRA,2019,15,11254,NA,11378,-124,-1.089822464404992
France,FRA,2019,16,11546,NA,11302,244,2.15890992744647
France,FRA,2019,17,11496,NA,11190,306,2.734584450402145
France,FRA,2019,18,11093,NA,11050,43,0.3891402714932127
France,FRA,2019,19,11266,NA,10929,337,3.0835392076127732
France,FRA,2019,20,11195,NA,10877,318,2.9236002574239217
France,FRA,2019,21,11053,NA,10911,142,1.3014389148565668
France,FRA,2019,22,10696,NA,10519,177,1.6826694552714139
France,FRA,2019,23,10591,NA,10400,191,1.8365384615384617
France,FRA,2019,24,10571,NA,10326,245,2.372651559171025
France,FRA,2019,25,10756,NA,10734,22,0.20495621389975777
France,FRA,2019,26,11400,NA,10693,707,6.611802113532217
France,FRA,2019,27,10998,NA,10886,112,1.028844387286423
France,FRA,2019,28,10555,NA,10450,105,1.0047846889952152
France,FRA,2019,29,10603,NA,10758,-155,-1.4407882506042016
France,FRA,2019,30,11623,NA,10836,787,7.262827611664821
France,FRA,2019,31,10369,NA,10526,-157,-1.4915447463423903
France,FRA,2019,32,10589,NA,10436,153,1.4660789574549635
France,FRA,2019,33,10235,NA,10294,-59,-0.5731494074217991
France,FRA,2019,34,10604,NA,10656,-52,-0.487987987987988
France,FRA,2019,35,11071,NA,10576,495,4.680408472012103
France,FRA,2019,36,10362,NA,10390,-28,-0.2694898941289702
France,FRA,2019,37,10796,NA,10658,138,1.2948020266466505
France,FRA,2019,38,11143,NA,10939,204,1.86488710119755
France,FRA,2019,39,10779,NA,10919,-140,-1.2821686967671033
France,FRA,2019,40,11188,NA,11156,32,0.28684116170670493
France,FRA,2019,41,11358,NA,11398,-40,-0.350938761186173
France,FRA,2019,42,11414,NA,11278,136,1.2058875687178578
France,FRA,2019,43,11448,NA,11375,73,0.6417582417582417
France,FRA,2019,44,11644,NA,11429,215,1.8811794557704087
France,FRA,2019,45,11813,NA,11663,150,1.2861184943839492
France,FRA,2019,46,11989,NA,11759,230,1.9559486350880178
France,FRA,2019,47,12364,NA,11886,478,4.021537943799428
France,FRA,2019,48,12250,NA,11928,322,2.699530516431925
France,FRA,2019,49,12180,NA,12043,137,1.1375903014199118
France,FRA,2019,50,12451,NA,12381,70,0.565382440836766
France,FRA,2019,51,12613,NA,12821,-208,-1.6223383511426566
France,FRA,2019,52,12433,NA,13246,-813,-6.137701947757813
France,FRA,2020,1,12960,0,13858,-898,-6.480011545677587
France,FRA,2020,2,13419,0,13919,-500,-3.5922120842014515
France,FRA,2020,3,12818,0,13571,-753,-5.5485962714612045
France,FRA,2020,4,12568,0,13430,-862,-6.418466120625466
France,FRA,2020,5,12755,0,13270,-515,-3.880934438583271
France,FRA,2020,6,12641,0,13243,-602,-4.545797779959224
France,FRA,2020,7,12487,1,12858,-371,-2.8853631980090215
France,FRA,2020,8,12067,0,12775,-708,-5.542074363992172
France,FRA,2020,9,12253,2,13012,-759,-5.833077159545035
France,FRA,2020,10,12375,27,12790,-415,-3.244722439405786
France,FRA,2020,11,12753,118,12232,521,4.259319816873774
France,FRA,2020,12,14152,712,11962,2190,18.307975254974085
France,FRA,2020,13,16376,2164,11880,4496,37.84511784511784
France,FRA,2020,14,18988,5887,11673,7315,62.66598132442388
France,FRA,2020,15,17714,6056,11378,6336,55.68641237475831
France,FRA,2020,16,15571,5298,11302,4269,37.772075738807295
France,FRA,2020,17,12962,3028,11190,1772,15.83556747095621
France,FRA,2020,18,11412,1908,11050,362,3.276018099547511
France,FRA,2020,19,11156,1442,10929,227,2.0770427303504437
France,FRA,2020,20,10796,1254,10877,-81,-0.7446906316079802
France,FRA,2020,21,11074,535,10911,163,1.4939052332508478
France,FRA,2020,22,10055,401,10519,-464,-4.411065690655006
Royaume-Uni,GBR,2016,1,54911,NA,51304,3607,7.03064088570092
Royaume-Uni,GBR,2016,2,48518,NA,55805,-7287,-13.05796971597527
Royaume-Uni,GBR,2016,3,48250,NA,53804,-5554,-10.322652590885436
Royaume-Uni,GBR,2016,4,47542,NA,52329,-4787,-9.14789122666208
Royaume-Uni,GBR,2016,5,46463,NA,50526,-4063,-8.041404425444327
Royaume-Uni,GBR,2016,6,46959,NA,49848,-2889,-5.795618680789601
Royaume-Uni,GBR,2016,7,44040,NA,48479,-4439,-9.1565420078797
Royaume-Uni,GBR,2016,8,45928,NA,48420,-2492,-5.146633622470054
Royaume-Uni,GBR,2016,9,47255,NA,46577,678,1.4556540781930996
Royaume-Uni,GBR,2016,10,46182,NA,48340,-2158,-4.4642118328506415
Royaume-Uni,GBR,2016,11,46197,NA,47132,-935,-1.9837902062293133
Royaume-Uni,GBR,2016,12,40454,NA,44288,-3834,-8.6569725433526
Royaume-Uni,GBR,2016,13,43240,NA,42101,1139,2.7053989216408163
Royaume-Uni,GBR,2016,14,48522,NA,44496,4026,9.048004314994607
Royaume-Uni,GBR,2016,15,47508,NA,44425,3083,6.939786156443444
Royaume-Uni,GBR,2016,16,45663,NA,42683,2980,6.9817023170817425
Royaume-Uni,GBR,2016,17,43703,NA,43749,-46,-0.1051452604630963
Royaume-Uni,GBR,2016,18,38414,NA,41521,-3107,-7.482960429662098
Royaume-Uni,GBR,2016,19,44536,NA,41005,3531,8.61114498231923
Royaume-Uni,GBR,2016,20,41670,NA,42621,-951,-2.2312944323220947
Royaume-Uni,GBR,2016,21,40832,NA,41649,-817,-1.9616317318543062
Royaume-Uni,GBR,2016,22,33669,NA,34621,-952,-2.7497761474249733
Royaume-Uni,GBR,2016,23,41435,NA,41717,-282,-0.6759834120382578
Royaume-Uni,GBR,2016,24,39471,NA,39439,32,0.08113795988742109
Royaume-Uni,GBR,2016,25,39337,NA,39642,-305,-0.7693860047424449
Royaume-Uni,GBR,2016,26,38866,NA,39252,-386,-0.9833893814327933
Royaume-Uni,GBR,2016,27,38522,NA,38604,-82,-0.21241322142783134
Royaume-Uni,GBR,2016,28,39411,NA,39170,241,0.6152667858054633
Royaume-Uni,GBR,2016,29,39379,NA,38548,831,2.155753865310781
Royaume-Uni,GBR,2016,30,39173,NA,38324,849,2.2153219914413946
Royaume-Uni,GBR,2016,31,38563,NA,38430,133,0.3460837887067395
Royaume-Uni,GBR,2016,32,38473,NA,38514,-41,-0.10645479565872151
Royaume-Uni,GBR,2016,33,38115,NA,38165,-50,-0.1310100877767588
Royaume-Uni,GBR,2016,34,39212,NA,38550,662,1.7172503242542152
Royaume-Uni,GBR,2016,35,33735,NA,34060,-325,-0.9541984732824428
Royaume-Uni,GBR,2016,36,39530,NA,39940,-410,-1.026539809714572
Royaume-Uni,GBR,2016,37,38387,NA,39194,-807,-2.058988620707251
Royaume-Uni,GBR,2016,38,37597,NA,39156,-1559,-3.9815098580038817
Royaume-Uni,GBR,2016,39,37877,NA,39358,-1481,-3.7628944560191067
Royaume-Uni,GBR,2016,40,39293,NA,40387,-1094,-2.7087924332087057
Royaume-Uni,GBR,2016,41,40826,NA,41362,-536,-1.2958754412262463
Royaume-Uni,GBR,2016,42,41141,NA,41852,-711,-1.698843543916659
Royaume-Uni,GBR,2016,43,40830,NA,41083,-253,-0.6158264975780736
Royaume-Uni,GBR,2016,44,42520,NA,41864,656,1.5669787884578636
Royaume-Uni,GBR,2016,45,43848,NA,43781,67,0.15303442132431877
Royaume-Uni,GBR,2016,46,45020,NA,43996,1024,2.3274843167560686
Royaume-Uni,GBR,2016,47,44601,NA,44257,344,0.7772781706848634
Royaume-Uni,GBR,2016,48,43989,NA,44173,-184,-0.41654404274104095
Royaume-Uni,GBR,2016,49,47150,NA,45321,1829,4.035656759559586
Royaume-Uni,GBR,2016,50,44498,NA,45953,-1455,-3.1662785889931016
Royaume-Uni,GBR,2016,51,48461,NA,49390,-929,-1.8809475602348653
Royaume-Uni,GBR,2017,1,50374,NA,51304,-930,-1.8127241540620613
Royaume-Uni,GBR,2017,2,57583,NA,55805,1778,3.186094435982439
Royaume-Uni,GBR,2017,3,56772,NA,53804,2968,5.516318489331648
Royaume-Uni,GBR,2017,4,53735,NA,52329,1406,2.6868466815723595
Royaume-Uni,GBR,2017,5,52519,NA,50526,1993,3.9445038198155404
Royaume-Uni,GBR,2017,6,51353,NA,49848,1505,3.019178302038196
Royaume-Uni,GBR,2017,7,48989,NA,48479,510,1.0520018977289136
Royaume-Uni,GBR,2017,8,49481,NA,48420,1061,2.191243287897563
Royaume-Uni,GBR,2017,9,47368,NA,46577,791,1.6982630912252827
Royaume-Uni,GBR,2017,10,46629,NA,48340,-1711,-3.5395117914770373
Royaume-Uni,GBR,2017,11,44868,NA,47132,-2264,-4.803530510056862
Royaume-Uni,GBR,2017,12,43630,NA,44288,-658,-1.485729768786127
Royaume-Uni,GBR,2017,13,42221,NA,42101,120,0.28502885917199117
Royaume-Uni,GBR,2017,14,41753,NA,44496,-2743,-6.164599065084502
Royaume-Uni,GBR,2017,15,35871,NA,44425,-8554,-19.254924029262803
Royaume-Uni,GBR,2017,16,40556,NA,42683,-2127,-4.983248600145257
Royaume-Uni,GBR,2017,17,45753,NA,43749,2004,4.580676129740109
Royaume-Uni,GBR,2017,18,38224,NA,41521,-3297,-7.940560198453794
Royaume-Uni,GBR,2017,19,44855,NA,41005,3850,9.389098890379222
Royaume-Uni,GBR,2017,20,43316,NA,42621,695,1.630651556744328
Royaume-Uni,GBR,2017,21,42253,NA,41649,604,1.4502148911138322
Royaume-Uni,GBR,2017,22,35215,NA,34621,594,1.715721671817683
Royaume-Uni,GBR,2017,23,41153,NA,41717,-564,-1.3519668240765157
Royaume-Uni,GBR,2017,24,39441,NA,39439,2,0.005071122492963818
Royaume-Uni,GBR,2017,25,40431,NA,39642,789,1.9903133040714394
Royaume-Uni,GBR,2017,26,39298,NA,39252,46,0.1171914806888821
Royaume-Uni,GBR,2017,27,39034,NA,38604,430,1.1138742099264325
Royaume-Uni,GBR,2017,28,39399,NA,39170,229,0.5846310952259381
Royaume-Uni,GBR,2017,29,38422,NA,38548,-126,-0.3268652070146311
Royaume-Uni,GBR,2017,30,37382,NA,38324,-942,-2.4579897714226076
Royaume-Uni,GBR,2017,31,37686,NA,38430,-744,-1.9359875097580015
Royaume-Uni,GBR,2017,32,37976,NA,38514,-538,-1.396894635716882
Royaume-Uni,GBR,2017,33,39069,NA,38165,904,2.3686623870037993
Royaume-Uni,GBR,2017,34,39524,NA,38550,974,2.5265888456549934
Royaume-Uni,GBR,2017,35,34403,NA,34060,343,1.0070463887257781
Royaume-Uni,GBR,2017,36,39954,NA,39940,14,0.03505257886830245
Royaume-Uni,GBR,2017,37,39608,NA,39194,414,1.056284125121192
Royaume-Uni,GBR,2017,38,40170,NA,39156,1014,2.589641434262948
Royaume-Uni,GBR,2017,39,40764,NA,39358,1406,3.572335992682555
Royaume-Uni,GBR,2017,40,41049,NA,40387,662,1.6391413078465842
Royaume-Uni,GBR,2017,41,41864,NA,41362,502,1.2136743871186113
Royaume-Uni,GBR,2017,42,42127,NA,41852,275,0.6570773200802829
Royaume-Uni,GBR,2017,43,41126,NA,41083,43,0.1046661636199888
Royaume-Uni,GBR,2017,44,42036,NA,41864,172,0.41085419453468375
Royaume-Uni,GBR,2017,45,43535,NA,43781,-246,-0.5618875768027226
Royaume-Uni,GBR,2017,46,43361,NA,43996,-635,-1.4433130284571325
Royaume-Uni,GBR,2017,47,44741,NA,44257,484,1.0936123099170751
Royaume-Uni,GBR,2017,48,44448,NA,44173,275,0.6225522377923166
Royaume-Uni,GBR,2017,49,45568,NA,45321,247,0.5450012135654553
Royaume-Uni,GBR,2017,50,47511,NA,45953,1558,3.3904206471829914
Royaume-Uni,GBR,2017,51,52825,NA,49390,3435,6.954849159748937
Royaume-Uni,GBR,2018,1,54023,NA,51304,2719,5.29978169343521
Royaume-Uni,GBR,2018,2,63917,NA,55805,8112,14.536331869904132
Royaume-Uni,GBR,2018,3,60156,NA,53804,6352,11.805813694149133
Royaume-Uni,GBR,2018,4,58889,NA,52329,6560,12.536069865657664
Royaume-Uni,GBR,2018,5,55711,NA,50526,5185,10.26204330443732
Royaume-Uni,GBR,2018,6,52074,NA,49848,2226,4.465575349061146
Royaume-Uni,GBR,2018,7,51375,NA,48479,2896,5.973720580044968
Royaume-Uni,GBR,2018,8,50753,NA,48420,2333,4.818256918628666
Royaume-Uni,GBR,2018,9,45336,NA,46577,-1241,-2.664405178521588
Royaume-Uni,GBR,2018,10,54658,NA,48340,6318,13.069921390153084
Royaume-Uni,GBR,2018,11,53155,NA,47132,6023,12.779003649325299
Royaume-Uni,GBR,2018,12,49412,NA,44288,5124,11.569725433526012
Royaume-Uni,GBR,2018,13,41458,NA,42101,-643,-1.5272796370632526
Royaume-Uni,GBR,2018,14,45275,NA,44496,779,1.7507191657677095
Royaume-Uni,GBR,2018,15,51150,NA,44425,6725,15.137872819358469
Royaume-Uni,GBR,2018,16,46785,NA,42683,4102,9.610383525056815
Royaume-Uni,GBR,2018,17,43093,NA,43749,-656,-1.4994628448650256
Royaume-Uni,GBR,2018,18,42547,NA,41521,1026,2.4710387514751573
Royaume-Uni,GBR,2018,19,36382,NA,41005,-4623,-11.274234849408609
Royaume-Uni,GBR,2018,20,42306,NA,42621,-315,-0.7390722883085803
Royaume-Uni,GBR,2018,21,40477,NA,41649,-1172,-2.8139931330884296
Royaume-Uni,GBR,2018,22,34523,NA,34621,-98,-0.2830651916466884
Royaume-Uni,GBR,2018,23,41774,NA,41717,57,0.13663494498645637
Royaume-Uni,GBR,2018,24,39078,NA,39439,-361,-0.915337609979969
Royaume-Uni,GBR,2018,25,38942,NA,39642,-700,-1.7658039453105294
Royaume-Uni,GBR,2018,26,38780,NA,39252,-472,-1.202486497503312
Royaume-Uni,GBR,2018,27,38761,NA,38604,157,0.406693606880116
Royaume-Uni,GBR,2018,28,39132,NA,39170,-38,-0.09701302016849629
Royaume-Uni,GBR,2018,29,38212,NA,38548,-336,-0.8716405520390164
Royaume-Uni,GBR,2018,30,38303,NA,38324,-21,-0.05479595031833837
Royaume-Uni,GBR,2018,31,38491,NA,38430,61,0.15873015873015872
Royaume-Uni,GBR,2018,32,39133,NA,38514,619,1.6072077686036246
Royaume-Uni,GBR,2018,33,37201,NA,38165,-964,-2.5258744923359098
Royaume-Uni,GBR,2018,34,37632,NA,38550,-918,-2.3813229571984436
Royaume-Uni,GBR,2018,35,33267,NA,34060,-793,-2.32824427480916
Royaume-Uni,GBR,2018,36,39588,NA,39940,-352,-0.8813219829744617
Royaume-Uni,GBR,2018,37,38653,NA,39194,-541,-1.380313313262234
Royaume-Uni,GBR,2018,38,39029,NA,39156,-127,-0.3243436510368781
Royaume-Uni,GBR,2018,39,38583,NA,39358,-775,-1.9691041211443672
Royaume-Uni,GBR,2018,40,39993,NA,40387,-394,-0.9755614430386016
Royaume-Uni,GBR,2018,41,40638,NA,41362,-724,-1.7503989168802283
Royaume-Uni,GBR,2018,42,41353,NA,41852,-499,-1.1922966644365862
Royaume-Uni,GBR,2018,43,40213,NA,41083,-870,-2.1176642406834945
Royaume-Uni,GBR,2018,44,40181,NA,41864,-1683,-4.0201605197783294
Royaume-Uni,GBR,2018,45,42671,NA,43781,-1110,-2.5353463831342364
Royaume-Uni,GBR,2018,46,42709,NA,43996,-1287,-2.925265933266661
Royaume-Uni,GBR,2018,47,41788,NA,44257,-2469,-5.578778498316651
Royaume-Uni,GBR,2018,48,42156,NA,44173,-2017,-4.566137685916736
Royaume-Uni,GBR,2018,49,43171,NA,45321,-2150,-4.743937688930076
Royaume-Uni,GBR,2018,50,44466,NA,45953,-1487,-3.235914956586077
Royaume-Uni,GBR,2018,51,46463,NA,49390,-2927,-5.926300870621583
Royaume-Uni,GBR,2019,1,45910,NA,51304,-5394,-10.513800093559956
Royaume-Uni,GBR,2019,2,53203,NA,55805,-2602,-4.662664635785324
Royaume-Uni,GBR,2019,3,50037,NA,53804,-3767,-7.00133819046911
Royaume-Uni,GBR,2019,4,49150,NA,52329,-3179,-6.075025320567945
Royaume-Uni,GBR,2019,5,47409,NA,50526,-3117,-6.169101056881606
Royaume-Uni,GBR,2019,6,49007,NA,49848,-841,-1.6871288717701813
Royaume-Uni,GBR,2019,7,49512,NA,48479,1033,2.130819530105819
Royaume-Uni,GBR,2019,8,47517,NA,48420,-903,-1.8649318463444857
Royaume-Uni,GBR,2019,9,46348,NA,46577,-229,-0.4916589733130086
Royaume-Uni,GBR,2019,10,45890,NA,48340,-2450,-5.068266446007447
Royaume-Uni,GBR,2019,11,44307,NA,47132,-2825,-5.99380463379445
Royaume-Uni,GBR,2019,12,43658,NA,44288,-630,-1.422507225433526
Royaume-Uni,GBR,2019,13,41485,NA,42101,-616,-1.4631481437495546
Royaume-Uni,GBR,2019,14,42435,NA,44496,-2061,-4.631877022653722
Royaume-Uni,GBR,2019,15,43171,NA,44425,-1254,-2.822734946539111
Royaume-Uni,GBR,2019,16,37727,NA,42683,-4956,-11.611180095119837
Royaume-Uni,GBR,2019,17,42448,NA,43749,-1301,-2.9737822578801802
Royaume-Uni,GBR,2019,18,46900,NA,41521,5379,12.954890296476481
Royaume-Uni,GBR,2019,19,38247,NA,41005,-2758,-6.726009023289843
Royaume-Uni,GBR,2019,20,43192,NA,42621,571,1.339715163886347
Royaume-Uni,GBR,2019,21,43034,NA,41649,1385,3.325409973828904
Royaume-Uni,GBR,2019,22,35078,NA,34621,457,1.3200080875769042
Royaume-Uni,GBR,2019,23,42505,NA,41717,788,1.888918186830309
Royaume-Uni,GBR,2019,24,39767,NA,39439,328,0.8316640888460661
Royaume-Uni,GBR,2019,25,39857,NA,39642,215,0.5423540689168055
Royaume-Uni,GBR,2019,26,40065,NA,39252,813,2.0712320391317642
Royaume-Uni,GBR,2019,27,38101,NA,38604,-503,-1.3029737850999896
Royaume-Uni,GBR,2019,28,38740,NA,39170,-430,-1.0977789124329844
Royaume-Uni,GBR,2019,29,38179,NA,38548,-369,-0.957248106257134
Royaume-Uni,GBR,2019,30,38437,NA,38324,113,0.2948543993320113
Royaume-Uni,GBR,2019,31,38981,NA,38430,551,1.4337756960707781
Royaume-Uni,GBR,2019,32,38475,NA,38514,-39,-0.10126187879732046
Royaume-Uni,GBR,2019,33,38276,NA,38165,111,0.29084239486440455
Royaume-Uni,GBR,2019,34,37831,NA,38550,-719,-1.8651102464332037
Royaume-Uni,GBR,2019,35,34835,NA,34060,775,2.275396359365825
Royaume-Uni,GBR,2019,36,40690,NA,39940,750,1.8778167250876314
Royaume-Uni,GBR,2019,37,40129,NA,39194,935,2.3855692197785374
Royaume-Uni,GBR,2019,38,39827,NA,39156,671,1.7136581877617734
Royaume-Uni,GBR,2019,39,40210,NA,39358,852,2.164744143503227
Royaume-Uni,GBR,2019,40,41212,NA,40387,825,2.0427365241290514
Royaume-Uni,GBR,2019,41,42118,NA,41362,756,1.8277646148638846
Royaume-Uni,GBR,2019,42,42785,NA,41852,933,2.2292841441269236
Royaume-Uni,GBR,2019,43,42164,NA,41083,1081,2.631258671469951
Royaume-Uni,GBR,2019,44,42721,NA,41864,857,2.047104911140837
Royaume-Uni,GBR,2019,45,45070,NA,43781,1289,2.94419953861264
Royaume-Uni,GBR,2019,46,44896,NA,43996,900,2.045640512773889
Royaume-Uni,GBR,2019,47,45898,NA,44257,1641,3.707888017714712
Royaume-Uni,GBR,2019,48,46099,NA,44173,1926,4.360129490865461
Royaume-Uni,GBR,2019,49,45395,NA,45321,74,0.1632797158050352
Royaume-Uni,GBR,2019,50,47337,NA,45953,1384,3.0117728983961873
Royaume-Uni,GBR,2019,51,49813,NA,49390,423,0.8564486738206114
Royaume-Uni,GBR,2020,1,50476,0,51304,-828,-1.6139092468423515
Royaume-Uni,GBR,2020,2,59121,0,55805,3316,5.942119881731028
Royaume-Uni,GBR,2020,3,54572,0,53804,768,1.427403167050777
Royaume-Uni,GBR,2020,4,49769,0,52329,-2560,-4.892124825622504
Royaume-Uni,GBR,2020,5,48686,0,50526,-1840,-3.641689427225587
Royaume-Uni,GBR,2020,6,46275,0,49848,-3573,-7.167790081848821
Royaume-Uni,GBR,2020,7,45906,0,48479,-2573,-5.3074527114833225
Royaume-Uni,GBR,2020,8,45522,0,48420,-2898,-5.985130111524164
Royaume-Uni,GBR,2020,9,45571,0,46577,-1006,-2.159864310711295
Royaume-Uni,GBR,2020,10,45914,3,48340,-2426,-5.0186181216383945
Royaume-Uni,GBR,2020,11,46340,62,47132,-792,-1.6803869982177713
Royaume-Uni,GBR,2020,12,44726,294,44288,438,0.9889812138728323
Royaume-Uni,GBR,2020,13,46547,1684,42101,4446,10.560319232322273
Royaume-Uni,GBR,2020,14,68912,4390,44496,24416,54.87234807623157
Royaume-Uni,GBR,2020,15,77887,6596,44425,33462,75.32245357343838
Royaume-Uni,GBR,2020,16,92840,6022,42683,50157,117.51048426774125
Royaume-Uni,GBR,2020,17,91380,5342,43749,47631,108.8733456764726
Royaume-Uni,GBR,2020,18,75035,4341,41521,33514,80.71578237518364
Royaume-Uni,GBR,2020,19,53421,3331,41005,12416,30.27923423972686
Royaume-Uni,GBR,2020,20,61100,2731,42621,18479,43.35656131953732
Royaume-Uni,GBR,2020,21,51532,2118,41649,9883,23.729261206751662
Royaume-Uni,GBR,2020,22,41564,2131,34621,6943,20.054302302070997
Hongrie,HUN,2016,1,2823,NA,2907,-84,-2.8895768833849327
Hongrie,HUN,2016,2,2640,NA,2897,-257,-8.87124611667242
Hongrie,HUN,2016,3,2562,NA,2931,-369,-12.589559877175024
Hongrie,HUN,2016,4,2615,NA,3020,-405,-13.410596026490065
Hongrie,HUN,2016,5,2483,NA,3054,-571,-18.696791093647676
Hongrie,HUN,2016,6,2640,NA,2998,-358,-11.941294196130753
Hongrie,HUN,2016,7,2575,NA,2909,-334,-11.481608800275009
Hongrie,HUN,2016,8,2491,NA,2858,-367,-12.841147655703288
Hongrie,HUN,2016,9,2535,NA,2837,-302,-10.645047585477617
Hongrie,HUN,2016,10,2496,NA,2774,-278,-10.021629416005768
Hongrie,HUN,2016,11,2438,NA,2692,-254,-9.435364041604755
Hongrie,HUN,2016,12,2481,NA,2603,-122,-4.6868997310795235
Hongrie,HUN,2016,13,2537,NA,2567,-30,-1.168679392286716
Hongrie,HUN,2016,14,2456,NA,2478,-22,-0.8878127522195319
Hongrie,HUN,2016,15,2318,NA,2445,-127,-5.194274028629857
Hongrie,HUN,2016,16,2349,NA,2385,-36,-1.509433962264151
Hongrie,HUN,2016,17,2364,NA,2396,-32,-1.335559265442404
Hongrie,HUN,2016,18,2279,NA,2342,-63,-2.69000853970965
Hongrie,HUN,2016,19,2370,NA,2288,82,3.583916083916084
Hongrie,HUN,2016,20,2381,NA,2266,115,5.075022065313328
Hongrie,HUN,2016,21,2261,NA,2276,-15,-0.6590509666080844
Hongrie,HUN,2016,22,2285,NA,2314,-29,-1.2532411408815902
Hongrie,HUN,2016,23,2235,NA,2219,16,0.7210455159981974
Hongrie,HUN,2016,24,2151,NA,2290,-139,-6.069868995633188
Hongrie,HUN,2016,25,2481,NA,2296,185,8.057491289198607
Hongrie,HUN,2016,26,2303,NA,2206,97,4.397098821396192
Hongrie,HUN,2016,27,2102,NA,2178,-76,-3.489439853076217
Hongrie,HUN,2016,28,2276,NA,2228,48,2.154398563734291
Hongrie,HUN,2016,29,2210,NA,2260,-50,-2.2123893805309733
Hongrie,HUN,2016,30,2277,NA,2319,-42,-1.8111254851228977
Hongrie,HUN,2016,31,2221,NA,2382,-161,-6.7590260285474395
Hongrie,HUN,2016,32,2120,NA,2262,-142,-6.2776304155614495
Hongrie,HUN,2016,33,2222,NA,2196,26,1.1839708561020037
Hongrie,HUN,2016,34,2241,NA,2238,3,0.13404825737265416
Hongrie,HUN,2016,35,2320,NA,2296,24,1.0452961672473868
Hongrie,HUN,2016,36,2246,NA,2224,22,0.9892086330935251
Hongrie,HUN,2016,37,2365,NA,2291,74,3.2300305543430814
Hongrie,HUN,2016,38,2263,NA,2300,-37,-1.608695652173913
Hongrie,HUN,2016,39,2423,NA,2408,15,0.6229235880398671
Hongrie,HUN,2016,40,2447,NA,2454,-7,-0.28524857375713125
Hongrie,HUN,2016,41,2538,NA,2482,56,2.2562449637389204
Hongrie,HUN,2016,42,2493,NA,2419,74,3.059115336916081
Hongrie,HUN,2016,43,2527,NA,2407,120,4.985459077690071
Hongrie,HUN,2016,44,2458,NA,2378,80,3.36417157275021
Hongrie,HUN,2016,45,2471,NA,2400,71,2.9583333333333335
Hongrie,HUN,2016,46,2483,NA,2418,65,2.6881720430107525
Hongrie,HUN,2016,47,2539,NA,2474,65,2.6273241713823765
Hongrie,HUN,2016,48,2540,NA,2473,67,2.7092600080873432
Hongrie,HUN,2016,49,2635,NA,2623,12,0.4574914220358368
Hongrie,HUN,2016,50,2585,NA,2592,-7,-0.2700617283950617
Hongrie,HUN,2016,51,2845,NA,2696,149,5.526706231454006
Hongrie,HUN,2016,52,2897,NA,2720,177,6.507352941176471
Hongrie,HUN,2017,1,3155,NA,2907,248,8.531131750945994
Hongrie,HUN,2017,2,3311,NA,2897,414,14.290645495340007
Hongrie,HUN,2017,3,3449,NA,2931,518,17.673149095871715
Hongrie,HUN,2017,4,3574,NA,3020,554,18.344370860927153
Hongrie,HUN,2017,5,3616,NA,3054,562,18.402095612311722
Hongrie,HUN,2017,6,3256,NA,2998,258,8.605737158105404
Hongrie,HUN,2017,7,2991,NA,2909,82,2.8188380886902715
Hongrie,HUN,2017,8,2890,NA,2858,32,1.119664100769769
Hongrie,HUN,2017,9,2668,NA,2837,-169,-5.956996827634826
Hongrie,HUN,2017,10,2671,NA,2774,-103,-3.713049747656813
Hongrie,HUN,2017,11,2582,NA,2692,-110,-4.086181277860327
Hongrie,HUN,2017,12,2584,NA,2603,-19,-0.7299270072992701
Hongrie,HUN,2017,13,2546,NA,2567,-21,-0.8180755746007012
Hongrie,HUN,2017,14,2422,NA,2478,-56,-2.2598870056497176
Hongrie,HUN,2017,15,2492,NA,2445,47,1.9222903885480573
Hongrie,HUN,2017,16,2527,NA,2385,142,5.953878406708595
Hongrie,HUN,2017,17,2480,NA,2396,84,3.5058430717863103
Hongrie,HUN,2017,18,2479,NA,2342,137,5.849701110162255
Hongrie,HUN,2017,19,2340,NA,2288,52,2.272727272727273
Hongrie,HUN,2017,20,2323,NA,2266,57,2.5154457193292146
Hongrie,HUN,2017,21,2209,NA,2276,-67,-2.9437609841827768
Hongrie,HUN,2017,22,2382,NA,2314,68,2.938634399308557
Hongrie,HUN,2017,23,2126,NA,2219,-93,-4.191077061739523
Hongrie,HUN,2017,24,2145,NA,2290,-145,-6.331877729257641
Hongrie,HUN,2017,25,2297,NA,2296,1,0.04355400696864112
Hongrie,HUN,2017,26,2136,NA,2206,-70,-3.1731640979147784
Hongrie,HUN,2017,27,2143,NA,2178,-35,-1.6069788797061526
Hongrie,HUN,2017,28,2288,NA,2228,60,2.6929982046678633
Hongrie,HUN,2017,29,2271,NA,2260,11,0.48672566371681414
Hongrie,HUN,2017,30,2140,NA,2319,-179,-7.71884432945235
Hongrie,HUN,2017,31,2657,NA,2382,275,11.544920235096559
Hongrie,HUN,2017,32,2292,NA,2262,30,1.3262599469496021
Hongrie,HUN,2017,33,2147,NA,2196,-49,-2.2313296903460835
Hongrie,HUN,2017,34,2155,NA,2238,-83,-3.708668453976765
Hongrie,HUN,2017,35,2239,NA,2296,-57,-2.4825783972125435
Hongrie,HUN,2017,36,2186,NA,2224,-38,-1.70863309352518
Hongrie,HUN,2017,37,2290,NA,2291,-1,-0.043649061545176775
Hongrie,HUN,2017,38,2312,NA,2300,12,0.5217391304347827
Hongrie,HUN,2017,39,2351,NA,2408,-57,-2.367109634551495
Hongrie,HUN,2017,40,2428,NA,2454,-26,-1.0594947025264874
Hongrie,HUN,2017,41,2496,NA,2482,14,0.5640612409347301
Hongrie,HUN,2017,42,2357,NA,2419,-62,-2.563042579578338
Hongrie,HUN,2017,43,2338,NA,2407,-69,-2.8666389696717904
Hongrie,HUN,2017,44,2397,NA,2378,19,0.798990748528175
Hongrie,HUN,2017,45,2324,NA,2400,-76,-3.166666666666667
Hongrie,HUN,2017,46,2423,NA,2418,5,0.20678246484698098
Hongrie,HUN,2017,47,2503,NA,2474,29,1.1721907841552142
Hongrie,HUN,2017,48,2437,NA,2473,-36,-1.4557217953902144
Hongrie,HUN,2017,49,2655,NA,2623,32,1.2199771254288982
Hongrie,HUN,2017,50,2580,NA,2592,-12,-0.4629629629629629
Hongrie,HUN,2017,51,2605,NA,2696,-91,-3.3753709198813056
Hongrie,HUN,2017,52,2628,NA,2720,-92,-3.3823529411764706
Hongrie,HUN,2018,1,2595,NA,2907,-312,-10.732714138286893
Hongrie,HUN,2018,2,2546,NA,2897,-351,-12.115982050396962
Hongrie,HUN,2018,3,2675,NA,2931,-256,-8.734220402592973
Hongrie,HUN,2018,4,2655,NA,3020,-365,-12.08609271523179
Hongrie,HUN,2018,5,2731,NA,3054,-323,-10.576293385723641
Hongrie,HUN,2018,6,2833,NA,2998,-165,-5.503669112741828
Hongrie,HUN,2018,7,3037,NA,2909,128,4.4001375042970094
Hongrie,HUN,2018,8,3161,NA,2858,303,10.601819454163751
Hongrie,HUN,2018,9,3237,NA,2837,400,14.099400775467041
Hongrie,HUN,2018,10,3218,NA,2774,444,16.005767844268203
Hongrie,HUN,2018,11,3016,NA,2692,324,12.035661218424963
Hongrie,HUN,2018,12,2878,NA,2603,275,10.564733000384171
Hongrie,HUN,2018,13,2774,NA,2567,207,8.06388780677834
Hongrie,HUN,2018,14,2622,NA,2478,144,5.811138014527845
Hongrie,HUN,2018,15,2576,NA,2445,131,5.357873210633947
Hongrie,HUN,2018,16,2336,NA,2385,-49,-2.0545073375262053
Hongrie,HUN,2018,17,2300,NA,2396,-96,-4.006677796327212
Hongrie,HUN,2018,18,2294,NA,2342,-48,-2.0495303159692573
Hongrie,HUN,2018,19,2160,NA,2288,-128,-5.594405594405594
Hongrie,HUN,2018,20,2154,NA,2266,-112,-4.942630185348632
Hongrie,HUN,2018,21,2352,NA,2276,76,3.3391915641476277
Hongrie,HUN,2018,22,2393,NA,2314,79,3.41400172860847
Hongrie,HUN,2018,23,2228,NA,2219,9,0.405588102748986
Hongrie,HUN,2018,24,2243,NA,2290,-47,-2.052401746724891
Hongrie,HUN,2018,25,2188,NA,2296,-108,-4.70383275261324
Hongrie,HUN,2018,26,2140,NA,2206,-66,-2.9918404351767904
Hongrie,HUN,2018,27,2225,NA,2178,47,2.157943067033976
Hongrie,HUN,2018,28,2285,NA,2228,57,2.55834829443447
Hongrie,HUN,2018,29,2265,NA,2260,5,0.22123893805309736
Hongrie,HUN,2018,30,2389,NA,2319,70,3.0185424752048298
Hongrie,HUN,2018,31,2479,NA,2382,97,4.072208228379513
Hongrie,HUN,2018,32,2419,NA,2262,157,6.94076038903625
Hongrie,HUN,2018,33,2199,NA,2196,3,0.1366120218579235
Hongrie,HUN,2018,34,2323,NA,2238,85,3.798033958891868
Hongrie,HUN,2018,35,2254,NA,2296,-42,-1.8292682926829267
Hongrie,HUN,2018,36,2267,NA,2224,43,1.9334532374100721
Hongrie,HUN,2018,37,2356,NA,2291,65,2.8371890004364904
Hongrie,HUN,2018,38,2385,NA,2300,85,3.6956521739130435
Hongrie,HUN,2018,39,2362,NA,2408,-46,-1.910299003322259
Hongrie,HUN,2018,40,2498,NA,2454,44,1.7929910350448246
Hongrie,HUN,2018,41,2512,NA,2482,30,1.20870265914585
Hongrie,HUN,2018,42,2432,NA,2419,13,0.5374121537825548
Hongrie,HUN,2018,43,2409,NA,2407,2,0.08309098462816784
Hongrie,HUN,2018,44,2361,NA,2378,-17,-0.7148864592094197
Hongrie,HUN,2018,45,2362,NA,2400,-38,-1.5833333333333335
Hongrie,HUN,2018,46,2408,NA,2418,-10,-0.41356492969396197
Hongrie,HUN,2018,47,2555,NA,2474,81,3.2740501212611157
Hongrie,HUN,2018,48,2559,NA,2473,86,3.4775576223210676
Hongrie,HUN,2018,49,2644,NA,2623,21,0.8006099885627144
Hongrie,HUN,2018,50,2677,NA,2592,85,3.279320987654321
Hongrie,HUN,2018,51,2797,NA,2696,101,3.746290801186944
Hongrie,HUN,2018,52,2860,NA,2720,140,5.147058823529411
Hongrie,HUN,2019,1,3054,NA,2907,147,5.056759545923633
Hongrie,HUN,2019,2,3090,NA,2897,193,6.662064204349328
Hongrie,HUN,2019,3,3037,NA,2931,106,3.6165131354486526
Hongrie,HUN,2019,4,3234,NA,3020,214,7.086092715231788
Hongrie,HUN,2019,5,3384,NA,3054,330,10.805500982318271
Hongrie,HUN,2019,6,3263,NA,2998,265,8.839226150767178
Hongrie,HUN,2019,7,3034,NA,2909,125,4.297009281540048
Hongrie,HUN,2019,8,2888,NA,2858,30,1.0496850944716585
Hongrie,HUN,2019,9,2909,NA,2837,72,2.5378921395840677
Hongrie,HUN,2019,10,2713,NA,2774,-61,-2.198990627253064
Hongrie,HUN,2019,11,2733,NA,2692,41,1.5230312035661218
Hongrie,HUN,2019,12,2469,NA,2603,-134,-5.147906262005378
Hongrie,HUN,2019,13,2411,NA,2567,-156,-6.077132839890923
Hongrie,HUN,2019,14,2414,NA,2478,-64,-2.58272800645682
Hongrie,HUN,2019,15,2393,NA,2445,-52,-2.12678936605317
Hongrie,HUN,2019,16,2327,NA,2385,-58,-2.431865828092243
Hongrie,HUN,2019,17,2442,NA,2396,46,1.9198664440734556
Hongrie,HUN,2019,18,2316,NA,2342,-26,-1.1101622544833476
Hongrie,HUN,2019,19,2283,NA,2288,-5,-0.21853146853146854
Hongrie,HUN,2019,20,2208,NA,2266,-58,-2.559576345984113
Hongrie,HUN,2019,21,2283,NA,2276,7,0.30755711775043937
Hongrie,HUN,2019,22,2196,NA,2314,-118,-5.099394987035436
Hongrie,HUN,2019,23,2288,NA,2219,69,3.1095087877422265
Hongrie,HUN,2019,24,2623,NA,2290,333,14.541484716157205
Hongrie,HUN,2019,25,2217,NA,2296,-79,-3.4407665505226483
Hongrie,HUN,2019,26,2247,NA,2206,41,1.85856754306437
Hongrie,HUN,2019,27,2242,NA,2178,64,2.938475665748393
Hongrie,HUN,2019,28,2065,NA,2228,-163,-7.3159784560143635
Hongrie,HUN,2019,29,2292,NA,2260,32,1.415929203539823
Hongrie,HUN,2019,30,2471,NA,2319,152,6.554549374730486
Hongrie,HUN,2019,31,2170,NA,2382,-212,-8.900083963056256
Hongrie,HUN,2019,32,2215,NA,2262,-47,-2.0778072502210434
Hongrie,HUN,2019,33,2218,NA,2196,22,1.0018214936247722
Hongrie,HUN,2019,34,2235,NA,2238,-3,-0.13404825737265416
Hongrie,HUN,2019,35,2373,NA,2296,77,3.353658536585366
Hongrie,HUN,2019,36,2199,NA,2224,-25,-1.1241007194244603
Hongrie,HUN,2019,37,2154,NA,2291,-137,-5.979921431689219
Hongrie,HUN,2019,38,2241,NA,2300,-59,-2.5652173913043477
Hongrie,HUN,2019,39,2494,NA,2408,86,3.571428571428571
Hongrie,HUN,2019,40,2442,NA,2454,-12,-0.4889975550122249
Hongrie,HUN,2019,41,2382,NA,2482,-100,-4.0290088638195005
Hongrie,HUN,2019,42,2394,NA,2419,-25,-1.0334849111202975
Hongrie,HUN,2019,43,2355,NA,2407,-52,-2.160365600332364
Hongrie,HUN,2019,44,2297,NA,2378,-81,-3.406223717409588
Hongrie,HUN,2019,45,2443,NA,2400,43,1.7916666666666667
Hongrie,HUN,2019,46,2358,NA,2418,-60,-2.481389578163772
Hongrie,HUN,2019,47,2301,NA,2474,-173,-6.992724333063864
Hongrie,HUN,2019,48,2355,NA,2473,-118,-4.771532551556813
Hongrie,HUN,2019,49,2558,NA,2623,-65,-2.4780785360274495
Hongrie,HUN,2019,50,2526,NA,2592,-66,-2.5462962962962963
Hongrie,HUN,2019,51,2536,NA,2696,-160,-5.934718100890208
Hongrie,HUN,2019,52,2494,NA,2720,-226,-8.308823529411764
Hongrie,HUN,2020,1,2609,NA,2907,-298,-10.251117991056072
Hongrie,HUN,2020,2,2582,NA,2897,-315,-10.873317224715223
Hongrie,HUN,2020,3,2582,NA,2931,-349,-11.90719890822245
Hongrie,HUN,2020,4,2718,NA,3020,-302,-10
Hongrie,HUN,2020,5,2798,NA,3054,-256,-8.382449246889326
Hongrie,HUN,2020,6,2633,NA,2998,-365,-12.17478318879253
Hongrie,HUN,2020,7,2750,NA,2909,-159,-5.465795806118941
Hongrie,HUN,2020,8,2584,NA,2858,-274,-9.587123862841148
Hongrie,HUN,2020,9,2778,NA,2837,-59,-2.0796616143813886
Hongrie,HUN,2020,10,2604,0,2774,-170,-6.128334534967555
Hongrie,HUN,2020,11,2576,1,2692,-116,-4.3090638930163445
Hongrie,HUN,2020,12,2792,7,2603,189,7.260852862082212
Hongrie,HUN,2020,13,2581,8,2567,14,0.5453837164004675
Hongrie,HUN,2020,14,2517,31,2478,39,1.573849878934625
Hongrie,HUN,2020,15,2561,75,2445,116,4.74437627811861
Hongrie,HUN,2020,16,2496,91,2385,111,4.654088050314465
Hongrie,HUN,2020,17,2338,78,2396,-58,-2.4207011686143574
Hongrie,HUN,2020,18,2213,72,2342,-129,-5.508112724167378
Hongrie,HUN,2020,19,2186,62,2288,-102,-4.458041958041958
Hongrie,HUN,2020,20,2193,42,2266,-73,-3.22153574580759
Islande,ISL,2016,1,44,NA,45,-1,-2.2222222222222223
Islande,ISL,2016,2,56,NA,49,7,14.285714285714285
Islande,ISL,2016,3,51,NA,44,7,15.909090909090908
Islande,ISL,2016,4,35,NA,44,-9,-20.454545454545457
Islande,ISL,2016,5,46,NA,46,0,0
Islande,ISL,2016,6,45,NA,46,-1,-2.1739130434782608
Islande,ISL,2016,7,39,NA,46,-7,-15.217391304347828
Islande,ISL,2016,8,40,NA,46,-6,-13.043478260869565
Islande,ISL,2016,9,39,NA,43,-4,-9.30232558139535
Islande,ISL,2016,10,51,NA,45,6,13.333333333333334
Islande,ISL,2016,11,44,NA,45,-1,-2.2222222222222223
Islande,ISL,2016,12,42,NA,41,1,2.4390243902439024
Islande,ISL,2016,13,43,NA,48,-5,-10.416666666666668
Islande,ISL,2016,14,48,NA,44,4,9.090909090909092
Islande,ISL,2016,15,47,NA,46,1,2.1739130434782608
Islande,ISL,2016,16,53,NA,49,4,8.16326530612245
Islande,ISL,2016,17,49,NA,45,4,8.88888888888889
Islande,ISL,2016,18,37,NA,40,-3,-7.5
Islande,ISL,2016,19,39,NA,43,-4,-9.30232558139535
Islande,ISL,2016,20,34,NA,40,-6,-15
Islande,ISL,2016,21,40,NA,42,-2,-4.761904761904762
Islande,ISL,2016,22,45,NA,44,1,2.272727272727273
Islande,ISL,2016,23,45,NA,47,-2,-4.25531914893617
Islande,ISL,2016,24,40,NA,39,1,2.564102564102564
Islande,ISL,2016,25,33,NA,39,-6,-15.384615384615385
Islande,ISL,2016,26,48,NA,51,-3,-5.88235294117647
Islande,ISL,2016,27,46,NA,43,3,6.976744186046512
Islande,ISL,2016,28,41,NA,39,2,5.128205128205128
Islande,ISL,2016,29,54,NA,41,13,31.70731707317073
Islande,ISL,2016,30,43,NA,42,1,2.380952380952381
Islande,ISL,2016,31,33,NA,34,-1,-2.941176470588235
Islande,ISL,2016,32,43,NA,40,3,7.5
Islande,ISL,2016,33,44,NA,36,8,22.22222222222222
Islande,ISL,2016,34,37,NA,43,-6,-13.953488372093023
Islande,ISL,2016,35,42,NA,38,4,10.526315789473683
Islande,ISL,2016,36,37,NA,37,0,0
Islande,ISL,2016,37,51,NA,44,7,15.909090909090908
Islande,ISL,2016,38,57,NA,42,15,35.714285714285715
Islande,ISL,2016,39,55,NA,51,4,7.8431372549019605
Islande,ISL,2016,40,47,NA,45,2,4.444444444444445
Islande,ISL,2016,41,41,NA,46,-5,-10.869565217391305
Islande,ISL,2016,42,50,NA,43,7,16.27906976744186
Islande,ISL,2016,43,48,NA,44,4,9.090909090909092
Islande,ISL,2016,44,40,NA,42,-2,-4.761904761904762
Islande,ISL,2016,45,48,NA,40,8,20
Islande,ISL,2016,46,49,NA,48,1,2.083333333333333
Islande,ISL,2016,47,38,NA,44,-6,-13.636363636363635
Islande,ISL,2016,48,30,NA,42,-12,-28.57142857142857
Islande,ISL,2016,49,43,NA,44,-1,-2.272727272727273
Islande,ISL,2016,50,48,NA,43,5,11.627906976744185
Islande,ISL,2016,51,52,NA,44,8,18.181818181818183
Islande,ISL,2016,52,45,NA,44,1,2.272727272727273
Islande,ISL,2017,1,35,NA,45,-10,-22.22222222222222
Islande,ISL,2017,2,53,NA,49,4,8.16326530612245
Islande,ISL,2017,3,46,NA,44,2,4.545454545454546
Islande,ISL,2017,4,53,NA,44,9,20.454545454545457
Islande,ISL,2017,5,48,NA,46,2,4.3478260869565215
Islande,ISL,2017,6,55,NA,46,9,19.565217391304348
Islande,ISL,2017,7,56,NA,46,10,21.73913043478261
Islande,ISL,2017,8,46,NA,46,0,0
Islande,ISL,2017,9,35,NA,43,-8,-18.6046511627907
Islande,ISL,2017,10,40,NA,45,-5,-11.11111111111111
Islande,ISL,2017,11,42,NA,45,-3,-6.666666666666667
Islande,ISL,2017,12,48,NA,41,7,17.073170731707318
Islande,ISL,2017,13,48,NA,48,0,0
Islande,ISL,2017,14,35,NA,44,-9,-20.454545454545457
Islande,ISL,2017,15,43,NA,46,-3,-6.521739130434782
Islande,ISL,2017,16,51,NA,49,2,4.081632653061225
Islande,ISL,2017,17,38,NA,45,-7,-15.555555555555555
Islande,ISL,2017,18,46,NA,40,6,15
Islande,ISL,2017,19,45,NA,43,2,4.651162790697675
Islande,ISL,2017,20,40,NA,40,0,0
Islande,ISL,2017,21,41,NA,42,-1,-2.380952380952381
Islande,ISL,2017,22,41,NA,44,-3,-6.8181818181818175
Islande,ISL,2017,23,44,NA,47,-3,-6.382978723404255
Islande,ISL,2017,24,40,NA,39,1,2.564102564102564
Islande,ISL,2017,25,47,NA,39,8,20.51282051282051
Islande,ISL,2017,26,43,NA,51,-8,-15.686274509803921
Islande,ISL,2017,27,47,NA,43,4,9.30232558139535
Islande,ISL,2017,28,35,NA,39,-4,-10.256410256410255
Islande,ISL,2017,29,46,NA,41,5,12.195121951219512
Islande,ISL,2017,30,40,NA,42,-2,-4.761904761904762
Islande,ISL,2017,31,31,NA,34,-3,-8.823529411764707
Islande,ISL,2017,32,38,NA,40,-2,-5
Islande,ISL,2017,33,40,NA,36,4,11.11111111111111
Islande,ISL,2017,34,44,NA,43,1,2.3255813953488373
Islande,ISL,2017,35,40,NA,38,2,5.263157894736842
Islande,ISL,2017,36,36,NA,37,-1,-2.7027027027027026
Islande,ISL,2017,37,45,NA,44,1,2.272727272727273
Islande,ISL,2017,38,35,NA,42,-7,-16.666666666666664
Islande,ISL,2017,39,47,NA,51,-4,-7.8431372549019605
Islande,ISL,2017,40,35,NA,45,-10,-22.22222222222222
Islande,ISL,2017,41,45,NA,46,-1,-2.1739130434782608
Islande,ISL,2017,42,47,NA,43,4,9.30232558139535
Islande,ISL,2017,43,38,NA,44,-6,-13.636363636363635
Islande,ISL,2017,44,39,NA,42,-3,-7.142857142857142
Islande,ISL,2017,45,37,NA,40,-3,-7.5
Islande,ISL,2017,46,51,NA,48,3,6.25
Islande,ISL,2017,47,47,NA,44,3,6.8181818181818175
Islande,ISL,2017,48,47,NA,42,5,11.904761904761903
Islande,ISL,2017,49,43,NA,44,-1,-2.272727272727273
Islande,ISL,2017,50,36,NA,43,-7,-16.27906976744186
Islande,ISL,2017,51,44,NA,44,0,0
Islande,ISL,2017,52,37,NA,44,-7,-15.909090909090908
Islande,ISL,2018,1,62,NA,45,17,37.77777777777778
Islande,ISL,2018,2,47,NA,49,-2,-4.081632653061225
Islande,ISL,2018,3,41,NA,44,-3,-6.8181818181818175
Islande,ISL,2018,4,50,NA,44,6,13.636363636363635
Islande,ISL,2018,5,47,NA,46,1,2.1739130434782608
Islande,ISL,2018,6,46,NA,46,0,0
Islande,ISL,2018,7,44,NA,46,-2,-4.3478260869565215
Islande,ISL,2018,8,57,NA,46,11,23.91304347826087
Islande,ISL,2018,9,50,NA,43,7,16.27906976744186
Islande,ISL,2018,10,43,NA,45,-2,-4.444444444444445
Islande,ISL,2018,11,37,NA,45,-8,-17.77777777777778
Islande,ISL,2018,12,36,NA,41,-5,-12.195121951219512
Islande,ISL,2018,13,55,NA,48,7,14.583333333333334
Islande,ISL,2018,14,55,NA,44,11,25
Islande,ISL,2018,15,51,NA,46,5,10.869565217391305
Islande,ISL,2018,16,45,NA,49,-4,-8.16326530612245
Islande,ISL,2018,17,41,NA,45,-4,-8.88888888888889
Islande,ISL,2018,18,32,NA,40,-8,-20
Islande,ISL,2018,19,43,NA,43,0,0
Islande,ISL,2018,20,38,NA,40,-2,-5
Islande,ISL,2018,21,51,NA,42,9,21.428571428571427
Islande,ISL,2018,22,50,NA,44,6,13.636363636363635
Islande,ISL,2018,23,54,NA,47,7,14.893617021276595
Islande,ISL,2018,24,35,NA,39,-4,-10.256410256410255
Islande,ISL,2018,25,36,NA,39,-3,-7.6923076923076925
Islande,ISL,2018,26,52,NA,51,1,1.9607843137254901
Islande,ISL,2018,27,40,NA,43,-3,-6.976744186046512
Islande,ISL,2018,28,38,NA,39,-1,-2.564102564102564
Islande,ISL,2018,29,33,NA,41,-8,-19.51219512195122
Islande,ISL,2018,30,30,NA,42,-12,-28.57142857142857
Islande,ISL,2018,31,41,NA,34,7,20.588235294117645
Islande,ISL,2018,32,45,NA,40,5,12.5
Islande,ISL,2018,33,25,NA,36,-11,-30.555555555555557
Islande,ISL,2018,34,38,NA,43,-5,-11.627906976744185
Islande,ISL,2018,35,36,NA,38,-2,-5.263157894736842
Islande,ISL,2018,36,41,NA,37,4,10.81081081081081
Islande,ISL,2018,37,45,NA,44,1,2.272727272727273
Islande,ISL,2018,38,33,NA,42,-9,-21.428571428571427
Islande,ISL,2018,39,50,NA,51,-1,-1.9607843137254901
Islande,ISL,2018,40,42,NA,45,-3,-6.666666666666667
Islande,ISL,2018,41,51,NA,46,5,10.869565217391305
Islande,ISL,2018,42,37,NA,43,-6,-13.953488372093023
Islande,ISL,2018,43,54,NA,44,10,22.727272727272727
Islande,ISL,2018,44,40,NA,42,-2,-4.761904761904762
Islande,ISL,2018,45,39,NA,40,-1,-2.5
Islande,ISL,2018,46,45,NA,48,-3,-6.25
Islande,ISL,2018,47,42,NA,44,-2,-4.545454545454546
Islande,ISL,2018,48,32,NA,42,-10,-23.809523809523807
Islande,ISL,2018,49,43,NA,44,-1,-2.272727272727273
Islande,ISL,2018,50,41,NA,43,-2,-4.651162790697675
Islande,ISL,2018,51,42,NA,44,-2,-4.545454545454546
Islande,ISL,2018,52,46,NA,44,2,4.545454545454546
Islande,ISL,2019,1,39,NA,45,-6,-13.333333333333334
Islande,ISL,2019,2,41,NA,49,-8,-16.3265306122449
Islande,ISL,2019,3,40,NA,44,-4,-9.090909090909092
Islande,ISL,2019,4,37,NA,44,-7,-15.909090909090908
Islande,ISL,2019,5,43,NA,46,-3,-6.521739130434782
Islande,ISL,2019,6,36,NA,46,-10,-21.73913043478261
Islande,ISL,2019,7,47,NA,46,1,2.1739130434782608
Islande,ISL,2019,8,41,NA,46,-5,-10.869565217391305
Islande,ISL,2019,9,47,NA,43,4,9.30232558139535
Islande,ISL,2019,10,47,NA,45,2,4.444444444444445
Islande,ISL,2019,11,57,NA,45,12,26.666666666666668
Islande,ISL,2019,12,37,NA,41,-4,-9.75609756097561
Islande,ISL,2019,13,48,NA,48,0,0
Islande,ISL,2019,14,38,NA,44,-6,-13.636363636363635
Islande,ISL,2019,15,42,NA,46,-4,-8.695652173913043
Islande,ISL,2019,16,47,NA,49,-2,-4.081632653061225
Islande,ISL,2019,17,53,NA,45,8,17.77777777777778
Islande,ISL,2019,18,45,NA,40,5,12.5
Islande,ISL,2019,19,44,NA,43,1,2.3255813953488373
Islande,ISL,2019,20,46,NA,40,6,15
Islande,ISL,2019,21,36,NA,42,-6,-14.285714285714285
Islande,ISL,2019,22,38,NA,44,-6,-13.636363636363635
Islande,ISL,2019,23,45,NA,47,-2,-4.25531914893617
Islande,ISL,2019,24,42,NA,39,3,7.6923076923076925
Islande,ISL,2019,25,39,NA,39,0,0
Islande,ISL,2019,26,60,NA,51,9,17.647058823529413
Islande,ISL,2019,27,40,NA,43,-3,-6.976744186046512
Islande,ISL,2019,28,42,NA,39,3,7.6923076923076925
Islande,ISL,2019,29,30,NA,41,-11,-26.82926829268293
Islande,ISL,2019,30,56,NA,42,14,33.33333333333333
Islande,ISL,2019,31,33,NA,34,-1,-2.941176470588235
Islande,ISL,2019,32,36,NA,40,-4,-10
Islande,ISL,2019,33,37,NA,36,1,2.7777777777777777
Islande,ISL,2019,34,53,NA,43,10,23.25581395348837
Islande,ISL,2019,35,36,NA,38,-2,-5.263157894736842
Islande,ISL,2019,36,34,NA,37,-3,-8.108108108108109
Islande,ISL,2019,37,33,NA,44,-11,-25
Islande,ISL,2019,38,45,NA,42,3,7.142857142857142
Islande,ISL,2019,39,53,NA,51,2,3.9215686274509802
Islande,ISL,2019,40,56,NA,45,11,24.444444444444443
Islande,ISL,2019,41,48,NA,46,2,4.3478260869565215
Islande,ISL,2019,42,38,NA,43,-5,-11.627906976744185
Islande,ISL,2019,43,38,NA,44,-6,-13.636363636363635
Islande,ISL,2019,44,50,NA,42,8,19.047619047619047
Islande,ISL,2019,45,38,NA,40,-2,-5
Islande,ISL,2019,46,45,NA,48,-3,-6.25
Islande,ISL,2019,47,51,NA,44,7,15.909090909090908
Islande,ISL,2019,48,58,NA,42,16,38.095238095238095
Islande,ISL,2019,49,45,NA,44,1,2.272727272727273
Islande,ISL,2019,50,46,NA,43,3,6.976744186046512
Islande,ISL,2019,51,36,NA,44,-8,-18.181818181818183
Islande,ISL,2019,52,49,NA,44,5,11.363636363636363
Islande,ISL,2020,1,57,0,45,12,26.666666666666668
Islande,ISL,2020,2,55,0,49,6,12.244897959183673
Islande,ISL,2020,3,52,0,44,8,18.181818181818183
Islande,ISL,2020,4,55,0,44,11,25
Islande,ISL,2020,5,39,0,46,-7,-15.217391304347828
Islande,ISL,2020,6,47,0,46,1,2.1739130434782608
Islande,ISL,2020,7,49,0,46,3,6.521739130434782
Islande,ISL,2020,8,48,0,46,2,4.3478260869565215
Islande,ISL,2020,9,43,0,43,0,0
Islande,ISL,2020,10,49,0,45,4,8.88888888888889
Islande,ISL,2020,11,43,0,45,-2,-4.444444444444445
Islande,ISL,2020,12,38,2,41,-3,-7.317073170731707
Islande,ISL,2020,13,42,0,48,-6,-12.5
Islande,ISL,2020,14,49,4,44,5,11.363636363636363
Islande,ISL,2020,15,47,2,46,1,2.1739130434782608
Islande,ISL,2020,16,60,2,49,11,22.448979591836736
Islande,ISL,2020,17,35,0,45,-10,-22.22222222222222
Islande,ISL,2020,18,43,0,40,3,7.5
Islande,ISL,2020,19,34,0,43,-9,-20.930232558139537
Islande,ISL,2020,20,40,0,40,0,0
Islande,ISL,2020,21,44,0,42,2,4.761904761904762
Islande,ISL,2020,22,7,0,44,-37,-84.0909090909091
Italie,ITA,2016,1,12637,NA,14455,-1818,-12.576962988585263
Italie,ITA,2016,2,12180,NA,14665,-2485,-16.94510739856802
Italie,ITA,2016,3,12594,NA,14464,-1870,-12.928650442477876
Italie,ITA,2016,4,12483,NA,13982,-1499,-10.720926906022028
Italie,ITA,2016,5,12128,NA,13778,-1650,-11.975613296559732
Italie,ITA,2016,6,12282,NA,13132,-850,-6.472738349070973
Italie,ITA,2016,7,11826,NA,12950,-1124,-8.67953667953668
Italie,ITA,2016,8,11860,NA,12744,-884,-6.936597614563716
Italie,ITA,2016,9,11912,NA,12792,-880,-6.879299562226391
Italie,ITA,2016,10,11950,NA,12534,-584,-4.659326631562151
Italie,ITA,2016,11,11978,NA,12185,-207,-1.6988100123102172
Italie,ITA,2016,12,11700,NA,11695,5,0.04275331338178709
Italie,ITA,2016,13,11897,NA,11714,183,1.5622332252006146
Italie,ITA,2016,14,11477,NA,11510,-33,-0.2867072111207646
Italie,ITA,2016,15,11018,NA,11241,-223,-1.9838092696379328
Italie,ITA,2016,16,10848,NA,11040,-192,-1.7391304347826086
Italie,ITA,2016,17,10670,NA,10974,-304,-2.770184071441589
Italie,ITA,2016,18,10880,NA,10827,53,0.4895169483698162
Italie,ITA,2016,19,10644,NA,10756,-112,-1.0412792859799183
Italie,ITA,2016,20,10276,NA,10557,-281,-2.6617410249123803
Italie,ITA,2016,21,10812,NA,10790,22,0.20389249304911955
Italie,ITA,2016,22,10085,NA,10534,-449,-4.262388456426809
Italie,ITA,2016,23,10348,NA,10576,-228,-2.155824508320726
Italie,ITA,2016,24,10069,NA,10602,-533,-5.02735332956046
Italie,ITA,2016,25,10747,NA,10674,73,0.6839048154393854
Italie,ITA,2016,26,10545,NA,10692,-147,-1.3748597081930416
Italie,ITA,2016,27,10575,NA,10763,-188,-1.7467248908296942
Italie,ITA,2016,28,10595,NA,10693,-98,-0.916487421677733
Italie,ITA,2016,29,10492,NA,10416,76,0.7296466973886329
Italie,ITA,2016,30,10325,NA,10601,-276,-2.603527969059523
Italie,ITA,2016,31,10253,NA,11059,-806,-7.288181571570666
Italie,ITA,2016,32,9938,NA,11336,-1398,-12.332392378263938
Italie,ITA,2016,33,10406,NA,10588,-182,-1.7189270872686058
Italie,ITA,2016,34,10526,NA,10416,110,1.056067588325653
Italie,ITA,2016,35,10084,NA,10229,-145,-1.417538371297292
Italie,ITA,2016,36,9825,NA,9967,-142,-1.4247015149994984
Italie,ITA,2016,37,9898,NA,10166,-268,-2.63623844186504
Italie,ITA,2016,38,9704,NA,10170,-466,-4.582104228121927
Italie,ITA,2016,39,10422,NA,10401,21,0.2019036631093164
Italie,ITA,2016,40,10407,NA,10582,-175,-1.6537516537516537
Italie,ITA,2016,41,11558,NA,11119,439,3.9481967802859974
Italie,ITA,2016,42,11296,NA,11010,286,2.5976385104450497
Italie,ITA,2016,43,11078,NA,11110,-32,-0.28802880288028804
Italie,ITA,2016,44,11026,NA,10839,187,1.7252514069563611
Italie,ITA,2016,45,11186,NA,11172,14,0.12531328320802004
Italie,ITA,2016,46,11700,NA,11445,255,2.2280471821756227
Italie,ITA,2016,47,11362,NA,11507,-145,-1.2601025462761797
Italie,ITA,2016,48,11398,NA,11527,-129,-1.1191116509065673
Italie,ITA,2016,49,11704,NA,11742,-38,-0.3236245954692557
Italie,ITA,2016,50,12433,NA,12258,175,1.4276390928373306
Italie,ITA,2016,51,13929,NA,12825,1104,8.608187134502925
Italie,ITA,2016,52,15448,NA,13437,2011,14.966138274912556
Italie,ITA,2017,1,16889,NA,14455,2434,16.838464199239016
Italie,ITA,2017,2,17722,NA,14665,3057,20.845550630753497
Italie,ITA,2017,3,16695,NA,14464,2231,15.42450221238938
Italie,ITA,2017,4,15345,NA,13982,1363,9.748247747103418
Italie,ITA,2017,5,14710,NA,13778,932,6.764407025693134
Italie,ITA,2017,6,13122,NA,13132,-10,-0.07614986293024673
Italie,ITA,2017,7,12882,NA,12950,-68,-0.525096525096525
Italie,ITA,2017,8,12385,NA,12744,-359,-2.8170119271814187
Italie,ITA,2017,9,12203,NA,12792,-589,-4.604440275171982
Italie,ITA,2017,10,12032,NA,12534,-502,-4.005106111377055
Italie,ITA,2017,11,11903,NA,12185,-282,-2.3143208863356586
Italie,ITA,2017,12,11751,NA,11695,56,0.4788371098760154
Italie,ITA,2017,13,11460,NA,11714,-254,-2.168345569404132
Italie,ITA,2017,14,11084,NA,11510,-426,-3.70112945264987
Italie,ITA,2017,15,11328,NA,11241,87,0.773952495329597
Italie,ITA,2017,16,10831,NA,11040,-209,-1.8931159420289854
Italie,ITA,2017,17,11207,NA,10974,233,2.1232002915983235
Italie,ITA,2017,18,11338,NA,10827,511,4.719682275792001
Italie,ITA,2017,19,11075,NA,10756,319,2.965786537746374
Italie,ITA,2017,20,10964,NA,10557,407,3.8552619115278963
Italie,ITA,2017,21,10811,NA,10790,21,0.19462465245597776
Italie,ITA,2017,22,10831,NA,10534,297,2.819441807480539
Italie,ITA,2017,23,10168,NA,10576,-408,-3.8577912254160367
Italie,ITA,2017,24,10782,NA,10602,180,1.697792869269949
Italie,ITA,2017,25,10962,NA,10674,288,2.6981450252951094
Italie,ITA,2017,26,10403,NA,10692,-289,-2.7029554807332583
Italie,ITA,2017,27,10427,NA,10763,-336,-3.1218061878658365
Italie,ITA,2017,28,10873,NA,10693,180,1.683344243897877
Italie,ITA,2017,29,10425,NA,10416,9,0.08640552995391705
Italie,ITA,2017,30,10378,NA,10601,-223,-2.103575134421281
Italie,ITA,2017,31,12145,NA,11059,1086,9.820056062935166
Italie,ITA,2017,32,13046,NA,11336,1710,15.084685956245588
Italie,ITA,2017,33,10912,NA,10588,324,3.0600680015111448
Italie,ITA,2017,34,10251,NA,10416,-165,-1.5841013824884793
Italie,ITA,2017,35,10421,NA,10229,192,1.8770163261315869
Italie,ITA,2017,36,9873,NA,9967,-94,-0.9431122704926256
Italie,ITA,2017,37,10060,NA,10166,-106,-1.0426913240212472
Italie,ITA,2017,38,10277,NA,10170,107,1.0521140609636186
Italie,ITA,2017,39,10721,NA,10401,320,3.0766272473800598
Italie,ITA,2017,40,10869,NA,10582,287,2.712152712152712
Italie,ITA,2017,41,11271,NA,11119,152,1.367029409119525
Italie,ITA,2017,42,11061,NA,11010,51,0.46321525885558584
Italie,ITA,2017,43,11158,NA,11110,48,0.43204320432043203
Italie,ITA,2017,44,10992,NA,10839,153,1.4115693329642955
Italie,ITA,2017,45,11455,NA,11172,283,2.5331185105621197
Italie,ITA,2017,46,11664,NA,11445,219,1.9134993446920052
Italie,ITA,2017,47,11666,NA,11507,159,1.381767619709742
Italie,ITA,2017,48,11785,NA,11527,258,2.2382233018131346
Italie,ITA,2017,49,12190,NA,11742,448,3.8153636518480667
Italie,ITA,2017,50,12672,NA,12258,414,3.3773861967694567
Italie,ITA,2017,51,12651,NA,12825,-174,-1.3567251461988303
Italie,ITA,2017,52,14043,NA,13437,606,4.509935253404778
Italie,ITA,2018,1,15164,NA,14455,709,4.904877205119336
Italie,ITA,2018,2,14886,NA,14665,221,1.5069894306171157
Italie,ITA,2018,3,14194,NA,14464,-270,-1.866703539823009
Italie,ITA,2018,4,13770,NA,13982,-212,-1.516235159490774
Italie,ITA,2018,5,13570,NA,13778,-208,-1.5096530701117723
Italie,ITA,2018,6,12935,NA,13132,-197,-1.5001522997258605
Italie,ITA,2018,7,13051,NA,12950,101,0.7799227799227799
Italie,ITA,2018,8,13036,NA,12744,292,2.29127432517263
Italie,ITA,2018,9,13413,NA,12792,621,4.854596622889306
Italie,ITA,2018,10,13238,NA,12534,704,5.616722514759854
Italie,ITA,2018,11,12441,NA,12185,256,2.1009437833401723
Italie,ITA,2018,12,11595,NA,11695,-100,-0.8550662676357419
Italie,ITA,2018,13,11903,NA,11714,189,1.613453986682602
Italie,ITA,2018,14,11601,NA,11510,91,0.7906168549087749
Italie,ITA,2018,15,11336,NA,11241,95,0.845120540877146
Italie,ITA,2018,16,11121,NA,11040,81,0.7336956521739131
Italie,ITA,2018,17,10935,NA,10974,-39,-0.3553854565336249
Italie,ITA,2018,18,10324,NA,10827,-503,-4.645792925094671
Italie,ITA,2018,19,10324,NA,10756,-432,-4.016362960208256
Italie,ITA,2018,20,10141,NA,10557,-416,-3.9405134034290046
Italie,ITA,2018,21,10632,NA,10790,-158,-1.464318813716404
Italie,ITA,2018,22,10594,NA,10534,60,0.569584203531422
Italie,ITA,2018,23,10302,NA,10576,-274,-2.590771558245083
Italie,ITA,2018,24,10365,NA,10602,-237,-2.2354272778720996
Italie,ITA,2018,25,10328,NA,10674,-346,-3.2415214540003747
Italie,ITA,2018,26,9919,NA,10692,-773,-7.229704451926675
Italie,ITA,2018,27,10460,NA,10763,-303,-2.815200222986156
Italie,ITA,2018,28,10425,NA,10693,-268,-2.506312540914617
Italie,ITA,2018,29,10445,NA,10416,29,0.2784178187403994
Italie,ITA,2018,30,10419,NA,10601,-182,-1.7168191680030185
Italie,ITA,2018,31,11546,NA,11059,487,4.403653133194683
Italie,ITA,2018,32,11713,NA,11336,377,3.325688073394496
Italie,ITA,2018,33,10511,NA,10588,-77,-0.7272383830751794
Italie,ITA,2018,34,10543,NA,10416,127,1.2192780337941629
Italie,ITA,2018,35,10171,NA,10229,-58,-0.5670153485189168
Italie,ITA,2018,36,10357,NA,9967,390,3.9129126116183404
Italie,ITA,2018,37,10384,NA,10166,218,2.144402911666339
Italie,ITA,2018,38,10458,NA,10170,288,2.831858407079646
Italie,ITA,2018,39,10188,NA,10401,-213,-2.047880011537352
Italie,ITA,2018,40,10771,NA,10582,189,1.7860517860517862
Italie,ITA,2018,41,10909,NA,11119,-210,-1.888659052073028
Italie,ITA,2018,42,10924,NA,11010,-86,-0.7811080835603996
Italie,ITA,2018,43,11146,NA,11110,36,0.32403240324032406
Italie,ITA,2018,44,10791,NA,10839,-48,-0.44284528092997505
Italie,ITA,2018,45,11048,NA,11172,-124,-1.1099176512710347
Italie,ITA,2018,46,11058,NA,11445,-387,-3.3813892529488863
Italie,ITA,2018,47,11737,NA,11507,230,1.9987833492656644
Italie,ITA,2018,48,11639,NA,11527,112,0.9716318209421358
Italie,ITA,2018,49,11918,NA,11742,176,1.498892863226026
Italie,ITA,2018,50,11995,NA,12258,-263,-2.1455376080926745
Italie,ITA,2018,51,12505,NA,12825,-320,-2.4951267056530213
Italie,ITA,2018,52,12605,NA,13437,-832,-6.191858301704249
Italie,ITA,2019,1,13131,NA,14455,-1324,-9.159460394327223
Italie,ITA,2019,2,13872,NA,14665,-793,-5.4074326628025915
Italie,ITA,2019,3,14371,NA,14464,-93,-0.6429756637168141
Italie,ITA,2019,4,14329,NA,13982,347,2.4817622657702763
Italie,ITA,2019,5,14704,NA,13778,926,6.720859340978372
Italie,ITA,2019,6,14188,NA,13132,1056,8.041425525434054
Italie,ITA,2019,7,14042,NA,12950,1092,8.432432432432432
Italie,ITA,2019,8,13696,NA,12744,952,7.470182046453234
Italie,ITA,2019,9,13641,NA,12792,849,6.636960600375234
Italie,ITA,2019,10,12915,NA,12534,381,3.0397319291527047
Italie,ITA,2019,11,12419,NA,12185,234,1.9203939269593764
Italie,ITA,2019,12,11734,NA,11695,39,0.33347584437793926
Italie,ITA,2019,13,11595,NA,11714,-119,-1.0158784360594162
Italie,ITA,2019,14,11877,NA,11510,367,3.1885317115551697
Italie,ITA,2019,15,11282,NA,11241,41,0.3647362334311894
Italie,ITA,2019,16,11360,NA,11040,320,2.898550724637681
Italie,ITA,2019,17,11086,NA,10974,112,1.0205941315837435
Italie,ITA,2019,18,10766,NA,10827,-61,-0.563406299067147
Italie,ITA,2019,19,10981,NA,10756,225,2.0918557084417997
Italie,ITA,2019,20,10847,NA,10557,290,2.7469925168134885
Italie,ITA,2019,21,10906,NA,10790,116,1.0750695088044486
Italie,ITA,2019,22,10624,NA,10534,90,0.8543763052971332
Italie,ITA,2019,23,11487,NA,10576,911,8.613842662632374
Italie,ITA,2019,24,11192,NA,10602,590,5.5649877381626105
Italie,ITA,2019,25,10658,NA,10674,-16,-0.14989694584972832
Italie,ITA,2019,26,11903,NA,10692,1211,11.326225215114103
Italie,ITA,2019,27,11590,NA,10763,827,7.6837313016816875
Italie,ITA,2019,28,10878,NA,10693,185,1.7301038062283738
Italie,ITA,2019,29,10304,NA,10416,-112,-1.0752688172043012
Italie,ITA,2019,30,11282,NA,10601,681,6.423922271483823
Italie,ITA,2019,31,10291,NA,11059,-768,-6.944570033456913
Italie,ITA,2019,32,10647,NA,11336,-689,-6.077981651376147
Italie,ITA,2019,33,10523,NA,10588,-65,-0.6139025311673593
Italie,ITA,2019,34,10342,NA,10416,-74,-0.7104454685099846
Italie,ITA,2019,35,10239,NA,10229,10,0.09776126698602015
Italie,ITA,2019,36,9814,NA,9967,-153,-1.5350657168656567
Italie,ITA,2019,37,10323,NA,10166,157,1.544363564823923
Italie,ITA,2019,38,10241,NA,10170,71,0.6981317600786627
Italie,ITA,2019,39,10274,NA,10401,-127,-1.2210364388039612
Italie,ITA,2019,40,10281,NA,10582,-301,-2.8444528444528445
Italie,ITA,2019,41,10739,NA,11119,-380,-3.4175735227988127
Italie,ITA,2019,42,10761,NA,11010,-249,-2.26158038147139
Italie,ITA,2019,43,11059,NA,11110,-51,-0.4590459045904591
Italie,ITA,2019,44,10546,NA,10839,-293,-2.7032014023433897
Italie,ITA,2019,45,11001,NA,11172,-171,-1.530612244897959
Italie,ITA,2019,46,11357,NA,11445,-88,-0.7688947138488422
Italie,ITA,2019,47,11264,NA,11507,-243,-2.111758060311115
Italie,ITA,2019,48,11287,NA,11527,-240,-2.082068187733148
Italie,ITA,2019,49,11156,NA,11742,-586,-4.990631919604837
Italie,ITA,2019,50,11934,NA,12258,-324,-2.643171806167401
Italie,ITA,2019,51,12216,NA,12825,-609,-4.748538011695906
Italie,ITA,2019,52,11653,NA,13437,-1784,-13.276773089231227
Italie,ITA,2020,1,12497,0,14455,-1958,-13.545485991006572
Italie,ITA,2020,2,12992,0,14665,-1673,-11.408114558472555
Italie,ITA,2020,3,13039,0,14464,-1425,-9.852046460176991
Italie,ITA,2020,4,13001,0,13982,-981,-7.016163638964383
Italie,ITA,2020,5,12848,0,13778,-930,-6.749891130788213
Italie,ITA,2020,6,12573,0,13132,-559,-4.256777337800792
Italie,ITA,2020,7,12590,0,12950,-360,-2.7799227799227797
Italie,ITA,2020,8,12216,6,12744,-528,-4.143126177024483
Italie,ITA,2020,9,12632,46,12792,-160,-1.2507817385866167
Italie,ITA,2020,10,13573,412,12534,1039,8.289452688686772
Italie,ITA,2020,11,17037,1694,12185,4852,39.81945014361921
Italie,ITA,2020,12,20579,3919,11695,8884,75.9640872167593
Italie,ITA,2020,13,21868,5514,11714,10154,86.68260201468328
Italie,ITA,2020,14,19004,4934,11510,7494,65.10860121633362
Italie,ITA,2020,15,17055,3940,11241,5814,51.72137710168134
Italie,ITA,2020,16,14916,3649,11040,3876,35.108695652173914
Italie,ITA,2020,17,12840,2863,10974,1866,17.00382722799344
Lituanie,LTU,2016,1,845,NA,868,-23,-2.6497695852534564
Lituanie,LTU,2016,2,896,NA,885,11,1.2429378531073447
Lituanie,LTU,2016,3,936,NA,924,12,1.2987012987012987
Lituanie,LTU,2016,4,906,NA,926,-20,-2.159827213822894
Lituanie,LTU,2016,5,913,NA,919,-6,-0.6528835690968444
Lituanie,LTU,2016,6,891,NA,906,-15,-1.6556291390728477
Lituanie,LTU,2016,7,836,NA,865,-29,-3.352601156069364
Lituanie,LTU,2016,8,862,NA,891,-29,-3.254769921436588
Lituanie,LTU,2016,9,826,NA,850,-24,-2.823529411764706
Lituanie,LTU,2016,10,820,NA,824,-4,-0.48543689320388345
Lituanie,LTU,2016,11,826,NA,800,26,3.25
Lituanie,LTU,2016,12,766,NA,778,-12,-1.5424164524421593
Lituanie,LTU,2016,13,824,NA,768,56,7.291666666666667
Lituanie,LTU,2016,14,790,NA,782,8,1.0230179028132993
Lituanie,LTU,2016,15,804,NA,770,34,4.415584415584416
Lituanie,LTU,2016,16,793,NA,759,34,4.479578392621871
Lituanie,LTU,2016,17,773,NA,756,17,2.2486772486772484
Lituanie,LTU,2016,18,767,NA,740,27,3.6486486486486487
Lituanie,LTU,2016,19,757,NA,754,3,0.3978779840848806
Lituanie,LTU,2016,20,723,NA,730,-7,-0.9589041095890412
Lituanie,LTU,2016,21,813,NA,770,43,5.584415584415584
Lituanie,LTU,2016,22,843,NA,743,100,13.458950201884253
Lituanie,LTU,2016,23,727,NA,715,12,1.6783216783216783
Lituanie,LTU,2016,24,664,NA,704,-40,-5.681818181818182
Lituanie,LTU,2016,25,760,NA,701,59,8.416547788873038
Lituanie,LTU,2016,26,860,NA,738,122,16.53116531165312
Lituanie,LTU,2016,27,688,NA,664,24,3.614457831325301
Lituanie,LTU,2016,28,675,NA,687,-12,-1.7467248908296942
Lituanie,LTU,2016,29,723,NA,708,15,2.11864406779661
Lituanie,LTU,2016,30,785,NA,743,42,5.652759084791386
Lituanie,LTU,2016,31,690,NA,689,1,0.14513788098693758
Lituanie,LTU,2016,32,665,NA,693,-28,-4.040404040404041
Lituanie,LTU,2016,33,715,NA,684,31,4.5321637426900585
Lituanie,LTU,2016,34,760,NA,682,78,11.436950146627565
Lituanie,LTU,2016,35,735,NA,700,35,5
Lituanie,LTU,2016,36,709,NA,672,37,5.5059523809523805
Lituanie,LTU,2016,37,653,NA,653,0,0
Lituanie,LTU,2016,38,732,NA,686,46,6.705539358600583
Lituanie,LTU,2016,39,743,NA,714,29,4.061624649859944
Lituanie,LTU,2016,40,760,NA,736,24,3.260869565217391
Lituanie,LTU,2016,41,795,NA,736,59,8.016304347826086
Lituanie,LTU,2016,42,814,NA,758,56,7.387862796833773
Lituanie,LTU,2016,43,810,NA,750,60,8
Lituanie,LTU,2016,44,794,NA,740,54,7.297297297297297
Lituanie,LTU,2016,45,822,NA,740,82,11.081081081081082
Lituanie,LTU,2016,46,802,NA,731,71,9.712722298221614
Lituanie,LTU,2016,47,776,NA,744,32,4.301075268817205
Lituanie,LTU,2016,48,752,NA,747,5,0.6693440428380187
Lituanie,LTU,2016,49,752,NA,766,-14,-1.8276762402088773
Lituanie,LTU,2016,50,759,NA,738,21,2.8455284552845526
Lituanie,LTU,2016,51,856,NA,782,74,9.462915601023019
Lituanie,LTU,2016,52,873,NA,810,63,7.777777777777778
Lituanie,LTU,2017,1,958,NA,868,90,10.368663594470046
Lituanie,LTU,2017,2,979,NA,885,94,10.621468926553671
Lituanie,LTU,2017,3,970,NA,924,46,4.978354978354979
Lituanie,LTU,2017,4,953,NA,926,27,2.915766738660907
Lituanie,LTU,2017,5,958,NA,919,39,4.243743199129488
Lituanie,LTU,2017,6,923,NA,906,17,1.8763796909492272
Lituanie,LTU,2017,7,877,NA,865,12,1.3872832369942196
Lituanie,LTU,2017,8,905,NA,891,14,1.5712682379349048
Lituanie,LTU,2017,9,828,NA,850,-22,-2.588235294117647
Lituanie,LTU,2017,10,790,NA,824,-34,-4.12621359223301
Lituanie,LTU,2017,11,763,NA,800,-37,-4.625
Lituanie,LTU,2017,12,765,NA,778,-13,-1.6709511568123392
Lituanie,LTU,2017,13,771,NA,768,3,0.390625
Lituanie,LTU,2017,14,757,NA,782,-25,-3.1969309462915603
Lituanie,LTU,2017,15,761,NA,770,-9,-1.1688311688311688
Lituanie,LTU,2017,16,749,NA,759,-10,-1.3175230566534915
Lituanie,LTU,2017,17,778,NA,756,22,2.91005291005291
Lituanie,LTU,2017,18,742,NA,740,2,0.2702702702702703
Lituanie,LTU,2017,19,793,NA,754,39,5.172413793103448
Lituanie,LTU,2017,20,762,NA,730,32,4.383561643835616
Lituanie,LTU,2017,21,771,NA,770,1,0.12987012987012986
Lituanie,LTU,2017,22,691,NA,743,-52,-6.998654104979811
Lituanie,LTU,2017,23,723,NA,715,8,1.118881118881119
Lituanie,LTU,2017,24,703,NA,704,-1,-0.14204545454545456
Lituanie,LTU,2017,25,723,NA,701,22,3.138373751783167
Lituanie,LTU,2017,26,700,NA,738,-38,-5.149051490514905
Lituanie,LTU,2017,27,668,NA,664,4,0.6024096385542169
Lituanie,LTU,2017,28,711,NA,687,24,3.4934497816593884
Lituanie,LTU,2017,29,697,NA,708,-11,-1.5536723163841808
Lituanie,LTU,2017,30,741,NA,743,-2,-0.2691790040376851
Lituanie,LTU,2017,31,647,NA,689,-42,-6.095791001451379
Lituanie,LTU,2017,32,707,NA,693,14,2.0202020202020203
Lituanie,LTU,2017,33,680,NA,684,-4,-0.5847953216374269
Lituanie,LTU,2017,34,595,NA,682,-87,-12.756598240469208
Lituanie,LTU,2017,35,728,NA,700,28,4
Lituanie,LTU,2017,36,688,NA,672,16,2.380952380952381
Lituanie,LTU,2017,37,679,NA,653,26,3.9816232771822357
Lituanie,LTU,2017,38,714,NA,686,28,4.081632653061225
Lituanie,LTU,2017,39,723,NA,714,9,1.2605042016806722
Lituanie,LTU,2017,40,768,NA,736,32,4.3478260869565215
Lituanie,LTU,2017,41,742,NA,736,6,0.8152173913043478
Lituanie,LTU,2017,42,773,NA,758,15,1.978891820580475
Lituanie,LTU,2017,43,777,NA,750,27,3.5999999999999996
Lituanie,LTU,2017,44,788,NA,740,48,6.486486486486487
Lituanie,LTU,2017,45,732,NA,740,-8,-1.0810810810810811
Lituanie,LTU,2017,46,784,NA,731,53,7.250341997264022
Lituanie,LTU,2017,47,770,NA,744,26,3.494623655913978
Lituanie,LTU,2017,48,721,NA,747,-26,-3.4805890227576977
Lituanie,LTU,2017,49,790,NA,766,24,3.1331592689295036
Lituanie,LTU,2017,50,693,NA,738,-45,-6.097560975609756
Lituanie,LTU,2017,51,781,NA,782,-1,-0.1278772378516624
Lituanie,LTU,2017,52,800,NA,810,-10,-1.2345679012345678
Lituanie,LTU,2018,1,826,NA,868,-42,-4.838709677419355
Lituanie,LTU,2018,2,788,NA,885,-97,-10.96045197740113
Lituanie,LTU,2018,3,879,NA,924,-45,-4.870129870129871
Lituanie,LTU,2018,4,862,NA,926,-64,-6.911447084233262
Lituanie,LTU,2018,5,911,NA,919,-8,-0.8705114254624592
Lituanie,LTU,2018,6,957,NA,906,51,5.629139072847682
Lituanie,LTU,2018,7,947,NA,865,82,9.479768786127167
Lituanie,LTU,2018,8,965,NA,891,74,8.305274971941639
Lituanie,LTU,2018,9,964,NA,850,114,13.411764705882353
Lituanie,LTU,2018,10,903,NA,824,79,9.587378640776699
Lituanie,LTU,2018,11,858,NA,800,58,7.249999999999999
Lituanie,LTU,2018,12,802,NA,778,24,3.0848329048843186
Lituanie,LTU,2018,13,800,NA,768,32,4.166666666666666
Lituanie,LTU,2018,14,856,NA,782,74,9.462915601023019
Lituanie,LTU,2018,15,790,NA,770,20,2.5974025974025974
Lituanie,LTU,2018,16,785,NA,759,26,3.4255599472990776
Lituanie,LTU,2018,17,701,NA,756,-55,-7.2751322751322745
Lituanie,LTU,2018,18,739,NA,740,-1,-0.13513513513513514
Lituanie,LTU,2018,19,777,NA,754,23,3.050397877984085
Lituanie,LTU,2018,20,726,NA,730,-4,-0.547945205479452
Lituanie,LTU,2018,21,708,NA,770,-62,-8.051948051948052
Lituanie,LTU,2018,22,730,NA,743,-13,-1.7496635262449527
Lituanie,LTU,2018,23,622,NA,715,-93,-13.006993006993007
Lituanie,LTU,2018,24,688,NA,704,-16,-2.272727272727273
Lituanie,LTU,2018,25,662,NA,701,-39,-5.563480741797433
Lituanie,LTU,2018,26,648,NA,738,-90,-12.195121951219512
Lituanie,LTU,2018,27,623,NA,664,-41,-6.174698795180722
Lituanie,LTU,2018,28,691,NA,687,4,0.5822416302765648
Lituanie,LTU,2018,29,733,NA,708,25,3.531073446327684
Lituanie,LTU,2018,30,719,NA,743,-24,-3.2301480484522207
Lituanie,LTU,2018,31,807,NA,689,118,17.126269956458636
Lituanie,LTU,2018,32,736,NA,693,43,6.204906204906205
Lituanie,LTU,2018,33,678,NA,684,-6,-0.8771929824561403
Lituanie,LTU,2018,34,694,NA,682,12,1.7595307917888565
Lituanie,LTU,2018,35,623,NA,700,-77,-11
Lituanie,LTU,2018,36,627,NA,672,-45,-6.696428571428571
Lituanie,LTU,2018,37,645,NA,653,-8,-1.2251148545176112
Lituanie,LTU,2018,38,658,NA,686,-28,-4.081632653061225
Lituanie,LTU,2018,39,682,NA,714,-32,-4.481792717086835
Lituanie,LTU,2018,40,701,NA,736,-35,-4.755434782608696
Lituanie,LTU,2018,41,729,NA,736,-7,-0.9510869565217392
Lituanie,LTU,2018,42,711,NA,758,-47,-6.200527704485488
Lituanie,LTU,2018,43,753,NA,750,3,0.4
Lituanie,LTU,2018,44,706,NA,740,-34,-4.594594594594595
Lituanie,LTU,2018,45,686,NA,740,-54,-7.297297297297297
Lituanie,LTU,2018,46,681,NA,731,-50,-6.839945280437757
Lituanie,LTU,2018,47,727,NA,744,-17,-2.28494623655914
Lituanie,LTU,2018,48,741,NA,747,-6,-0.8032128514056224
Lituanie,LTU,2018,49,843,NA,766,77,10.052219321148826
Lituanie,LTU,2018,50,773,NA,738,35,4.742547425474255
Lituanie,LTU,2018,51,770,NA,782,-12,-1.5345268542199488
Lituanie,LTU,2018,52,821,NA,810,11,1.3580246913580247
Lituanie,LTU,2019,1,842,NA,868,-26,-2.995391705069124
Lituanie,LTU,2019,2,878,NA,885,-7,-0.7909604519774011
Lituanie,LTU,2019,3,910,NA,924,-14,-1.5151515151515151
Lituanie,LTU,2019,4,982,NA,926,56,6.047516198704104
Lituanie,LTU,2019,5,895,NA,919,-24,-2.6115342763873777
Lituanie,LTU,2019,6,854,NA,906,-52,-5.739514348785872
Lituanie,LTU,2019,7,800,NA,865,-65,-7.514450867052023
Lituanie,LTU,2019,8,831,NA,891,-60,-6.7340067340067336
Lituanie,LTU,2019,9,783,NA,850,-67,-7.882352941176471
Lituanie,LTU,2019,10,783,NA,824,-41,-4.975728155339806
Lituanie,LTU,2019,11,754,NA,800,-46,-5.75
Lituanie,LTU,2019,12,780,NA,778,2,0.2570694087403599
Lituanie,LTU,2019,13,678,NA,768,-90,-11.71875
Lituanie,LTU,2019,14,726,NA,782,-56,-7.161125319693094
Lituanie,LTU,2019,15,723,NA,770,-47,-6.103896103896104
Lituanie,LTU,2019,16,709,NA,759,-50,-6.587615283267458
Lituanie,LTU,2019,17,773,NA,756,17,2.2486772486772484
Lituanie,LTU,2019,18,714,NA,740,-26,-3.5135135135135136
Lituanie,LTU,2019,19,691,NA,754,-63,-8.355437665782492
Lituanie,LTU,2019,20,707,NA,730,-23,-3.1506849315068495
Lituanie,LTU,2019,21,788,NA,770,18,2.3376623376623376
Lituanie,LTU,2019,22,708,NA,743,-35,-4.710632570659488
Lituanie,LTU,2019,23,788,NA,715,73,10.20979020979021
Lituanie,LTU,2019,24,763,NA,704,59,8.380681818181818
Lituanie,LTU,2019,25,660,NA,701,-41,-5.848787446504993
Lituanie,LTU,2019,26,746,NA,738,8,1.084010840108401
Lituanie,LTU,2019,27,677,NA,664,13,1.957831325301205
Lituanie,LTU,2019,28,671,NA,687,-16,-2.3289665211062593
Lituanie,LTU,2019,29,681,NA,708,-27,-3.8135593220338984
Lituanie,LTU,2019,30,727,NA,743,-16,-2.1534320323014806
Lituanie,LTU,2019,31,611,NA,689,-78,-11.320754716981133
Lituanie,LTU,2019,32,665,NA,693,-28,-4.040404040404041
Lituanie,LTU,2019,33,661,NA,684,-23,-3.3625730994152043
Lituanie,LTU,2019,34,680,NA,682,-2,-0.2932551319648094
Lituanie,LTU,2019,35,715,NA,700,15,2.142857142857143
Lituanie,LTU,2019,36,662,NA,672,-10,-1.488095238095238
Lituanie,LTU,2019,37,635,NA,653,-18,-2.756508422664625
Lituanie,LTU,2019,38,641,NA,686,-45,-6.559766763848396
Lituanie,LTU,2019,39,708,NA,714,-6,-0.8403361344537815
Lituanie,LTU,2019,40,714,NA,736,-22,-2.989130434782609
Lituanie,LTU,2019,41,678,NA,736,-58,-7.880434782608696
Lituanie,LTU,2019,42,732,NA,758,-26,-3.430079155672823
Lituanie,LTU,2019,43,661,NA,750,-89,-11.866666666666667
Lituanie,LTU,2019,44,671,NA,740,-69,-9.324324324324325
Lituanie,LTU,2019,45,720,NA,740,-20,-2.7027027027027026
Lituanie,LTU,2019,46,657,NA,731,-74,-10.12311901504788
Lituanie,LTU,2019,47,702,NA,744,-42,-5.64516129032258
Lituanie,LTU,2019,48,774,NA,747,27,3.614457831325301
Lituanie,LTU,2019,49,681,NA,766,-85,-11.096605744125327
Lituanie,LTU,2019,50,726,NA,738,-12,-1.6260162601626018
Lituanie,LTU,2019,51,720,NA,782,-62,-7.928388746803069
Lituanie,LTU,2019,52,748,NA,810,-62,-7.654320987654321
Lituanie,LTU,2020,1,538,0,868,-330,-38.0184331797235
Lituanie,LTU,2020,2,807,0,885,-78,-8.813559322033898
Lituanie,LTU,2020,3,783,0,924,-141,-15.259740259740258
Lituanie,LTU,2020,4,763,0,926,-163,-17.60259179265659
Lituanie,LTU,2020,5,793,0,919,-126,-13.710554951033732
Lituanie,LTU,2020,6,744,0,906,-162,-17.880794701986755
Lituanie,LTU,2020,7,813,0,865,-52,-6.011560693641618
Lituanie,LTU,2020,8,719,0,891,-172,-19.30415263748597
Lituanie,LTU,2020,9,793,0,850,-57,-6.705882352941177
Lituanie,LTU,2020,10,827,NA,824,3,0.3640776699029126
Lituanie,LTU,2020,11,696,0,800,-104,-13
Lituanie,LTU,2020,12,843,1,778,65,8.354755784061698
Lituanie,LTU,2020,13,772,6,768,4,0.5208333333333333
Lituanie,LTU,2020,14,808,7,782,26,3.324808184143223
Lituanie,LTU,2020,15,773,10,770,3,0.38961038961038963
Lituanie,LTU,2020,16,759,13,759,0,0
Lituanie,LTU,2020,17,791,4,756,35,4.62962962962963
Lituanie,LTU,2020,18,688,5,740,-52,-7.027027027027027
Lituanie,LTU,2020,19,805,4,754,51,6.763925729442971
Lituanie,LTU,2020,20,717,9,730,-13,-1.7808219178082192
Lituanie,LTU,2020,21,733,4,770,-37,-4.805194805194805
Lituanie,LTU,2020,22,721,7,743,-22,-2.9609690444145356
Lituanie,LTU,2020,23,744,1,715,29,4.055944055944056
Luxembourg,LUX,2016,1,75,NA,88,-13,-14.772727272727273
Luxembourg,LUX,2016,2,81,NA,96,-15,-15.625
Luxembourg,LUX,2016,3,85,NA,89,-4,-4.49438202247191
Luxembourg,LUX,2016,4,83,NA,88,-5,-5.681818181818182
Luxembourg,LUX,2016,5,79,NA,96,-17,-17.708333333333336
Luxembourg,LUX,2016,6,72,NA,96,-24,-25
Luxembourg,LUX,2016,7,85,NA,98,-13,-13.26530612244898
Luxembourg,LUX,2016,8,65,NA,84,-19,-22.61904761904762
Luxembourg,LUX,2016,9,82,NA,88,-6,-6.8181818181818175
Luxembourg,LUX,2016,10,91,NA,100,-9,-9
Luxembourg,LUX,2016,11,86,NA,81,5,6.172839506172839
Luxembourg,LUX,2016,12,91,NA,89,2,2.247191011235955
Luxembourg,LUX,2016,13,82,NA,86,-4,-4.651162790697675
Luxembourg,LUX,2016,14,78,NA,82,-4,-4.878048780487805
Luxembourg,LUX,2016,15,70,NA,71,-1,-1.4084507042253522
Luxembourg,LUX,2016,16,71,NA,79,-8,-10.126582278481013
Luxembourg,LUX,2016,17,63,NA,75,-12,-16
Luxembourg,LUX,2016,18,76,NA,74,2,2.7027027027027026
Luxembourg,LUX,2016,19,68,NA,71,-3,-4.225352112676056
Luxembourg,LUX,2016,20,77,NA,73,4,5.47945205479452
Luxembourg,LUX,2016,21,82,NA,80,2,2.5
Luxembourg,LUX,2016,22,72,NA,67,5,7.462686567164178
Luxembourg,LUX,2016,23,62,NA,74,-12,-16.216216216216218
Luxembourg,LUX,2016,24,81,NA,77,4,5.194805194805195
Luxembourg,LUX,2016,25,71,NA,64,7,10.9375
Luxembourg,LUX,2016,26,49,NA,72,-23,-31.944444444444443
Luxembourg,LUX,2016,27,70,NA,72,-2,-2.7777777777777777
Luxembourg,LUX,2016,28,80,NA,78,2,2.564102564102564
Luxembourg,LUX,2016,29,77,NA,73,4,5.47945205479452
Luxembourg,LUX,2016,30,74,NA,79,-5,-6.329113924050633
Luxembourg,LUX,2016,31,64,NA,76,-12,-15.789473684210526
Luxembourg,LUX,2016,32,69,NA,76,-7,-9.210526315789473
Luxembourg,LUX,2016,33,72,NA,75,-3,-4
Luxembourg,LUX,2016,34,69,NA,66,3,4.545454545454546
Luxembourg,LUX,2016,35,85,NA,78,7,8.974358974358974
Luxembourg,LUX,2016,36,71,NA,77,-6,-7.792207792207792
Luxembourg,LUX,2016,37,73,NA,72,1,1.3888888888888888
Luxembourg,LUX,2016,38,61,NA,68,-7,-10.294117647058822
Luxembourg,LUX,2016,39,77,NA,84,-7,-8.333333333333332
Luxembourg,LUX,2016,40,69,NA,80,-11,-13.750000000000002
Luxembourg,LUX,2016,41,85,NA,89,-4,-4.49438202247191
Luxembourg,LUX,2016,42,80,NA,77,3,3.896103896103896
Luxembourg,LUX,2016,43,71,NA,75,-4,-5.333333333333334
Luxembourg,LUX,2016,44,72,NA,86,-14,-16.27906976744186
Luxembourg,LUX,2016,45,76,NA,85,-9,-10.588235294117647
Luxembourg,LUX,2016,46,82,NA,82,0,0
Luxembourg,LUX,2016,47,73,NA,87,-14,-16.091954022988507
Luxembourg,LUX,2016,48,79,NA,78,1,1.282051282051282
Luxembourg,LUX,2016,49,81,NA,84,-3,-3.571428571428571
Luxembourg,LUX,2016,50,86,NA,84,2,2.380952380952381
Luxembourg,LUX,2016,51,76,NA,84,-8,-9.523809523809524
Luxembourg,LUX,2016,52,93,NA,91,2,2.197802197802198
Luxembourg,LUX,2017,1,95,NA,88,7,7.954545454545454
Luxembourg,LUX,2017,2,123,NA,96,27,28.125
Luxembourg,LUX,2017,3,107,NA,89,18,20.224719101123593
Luxembourg,LUX,2017,4,101,NA,88,13,14.772727272727273
Luxembourg,LUX,2017,5,110,NA,96,14,14.583333333333334
Luxembourg,LUX,2017,6,92,NA,96,-4,-4.166666666666666
Luxembourg,LUX,2017,7,86,NA,98,-12,-12.244897959183673
Luxembourg,LUX,2017,8,71,NA,84,-13,-15.476190476190476
Luxembourg,LUX,2017,9,67,NA,88,-21,-23.863636363636363
Luxembourg,LUX,2017,10,89,NA,100,-11,-11
Luxembourg,LUX,2017,11,75,NA,81,-6,-7.4074074074074066
Luxembourg,LUX,2017,12,89,NA,89,0,0
Luxembourg,LUX,2017,13,99,NA,86,13,15.11627906976744
Luxembourg,LUX,2017,14,97,NA,82,15,18.29268292682927
Luxembourg,LUX,2017,15,63,NA,71,-8,-11.267605633802818
Luxembourg,LUX,2017,16,83,NA,79,4,5.063291139240507
Luxembourg,LUX,2017,17,90,NA,75,15,20
Luxembourg,LUX,2017,18,74,NA,74,0,0
Luxembourg,LUX,2017,19,73,NA,71,2,2.8169014084507045
Luxembourg,LUX,2017,20,63,NA,73,-10,-13.698630136986301
Luxembourg,LUX,2017,21,72,NA,80,-8,-10
Luxembourg,LUX,2017,22,64,NA,67,-3,-4.477611940298507
Luxembourg,LUX,2017,23,76,NA,74,2,2.7027027027027026
Luxembourg,LUX,2017,24,86,NA,77,9,11.688311688311687
Luxembourg,LUX,2017,25,66,NA,64,2,3.125
Luxembourg,LUX,2017,26,72,NA,72,0,0
Luxembourg,LUX,2017,27,71,NA,72,-1,-1.3888888888888888
Luxembourg,LUX,2017,28,85,NA,78,7,8.974358974358974
Luxembourg,LUX,2017,29,76,NA,73,3,4.10958904109589
Luxembourg,LUX,2017,30,83,NA,79,4,5.063291139240507
Luxembourg,LUX,2017,31,66,NA,76,-10,-13.157894736842104
Luxembourg,LUX,2017,32,59,NA,76,-17,-22.36842105263158
Luxembourg,LUX,2017,33,67,NA,75,-8,-10.666666666666668
Luxembourg,LUX,2017,34,71,NA,66,5,7.575757575757576
Luxembourg,LUX,2017,35,76,NA,78,-2,-2.564102564102564
Luxembourg,LUX,2017,36,75,NA,77,-2,-2.5974025974025974
Luxembourg,LUX,2017,37,78,NA,72,6,8.333333333333332
Luxembourg,LUX,2017,38,79,NA,68,11,16.176470588235293
Luxembourg,LUX,2017,39,88,NA,84,4,4.761904761904762
Luxembourg,LUX,2017,40,78,NA,80,-2,-2.5
Luxembourg,LUX,2017,41,94,NA,89,5,5.617977528089887
Luxembourg,LUX,2017,42,80,NA,77,3,3.896103896103896
Luxembourg,LUX,2017,43,84,NA,75,9,12
Luxembourg,LUX,2017,44,84,NA,86,-2,-2.3255813953488373
Luxembourg,LUX,2017,45,77,NA,85,-8,-9.411764705882353
Luxembourg,LUX,2017,46,75,NA,82,-7,-8.536585365853659
Luxembourg,LUX,2017,47,96,NA,87,9,10.344827586206897
Luxembourg,LUX,2017,48,70,NA,78,-8,-10.256410256410255
Luxembourg,LUX,2017,49,97,NA,84,13,15.476190476190476
Luxembourg,LUX,2017,50,78,NA,84,-6,-7.142857142857142
Luxembourg,LUX,2017,51,85,NA,84,1,1.1904761904761905
Luxembourg,LUX,2017,52,96,NA,91,5,5.4945054945054945
Luxembourg,LUX,2018,1,85,NA,88,-3,-3.4090909090909087
Luxembourg,LUX,2018,2,100,NA,96,4,4.166666666666666
Luxembourg,LUX,2018,3,84,NA,89,-5,-5.617977528089887
Luxembourg,LUX,2018,4,85,NA,88,-3,-3.4090909090909087
Luxembourg,LUX,2018,5,96,NA,96,0,0
Luxembourg,LUX,2018,6,115,NA,96,19,19.791666666666664
Luxembourg,LUX,2018,7,111,NA,98,13,13.26530612244898
Luxembourg,LUX,2018,8,112,NA,84,28,33.33333333333333
Luxembourg,LUX,2018,9,111,NA,88,23,26.136363636363637
Luxembourg,LUX,2018,10,135,NA,100,35,35
Luxembourg,LUX,2018,11,85,NA,81,4,4.938271604938271
Luxembourg,LUX,2018,12,94,NA,89,5,5.617977528089887
Luxembourg,LUX,2018,13,70,NA,86,-16,-18.6046511627907
Luxembourg,LUX,2018,14,75,NA,82,-7,-8.536585365853659
Luxembourg,LUX,2018,15,80,NA,71,9,12.676056338028168
Luxembourg,LUX,2018,16,83,NA,79,4,5.063291139240507
Luxembourg,LUX,2018,17,64,NA,75,-11,-14.666666666666666
Luxembourg,LUX,2018,18,67,NA,74,-7,-9.45945945945946
Luxembourg,LUX,2018,19,77,NA,71,6,8.450704225352112
Luxembourg,LUX,2018,20,75,NA,73,2,2.73972602739726
Luxembourg,LUX,2018,21,84,NA,80,4,5
Luxembourg,LUX,2018,22,53,NA,67,-14,-20.8955223880597
Luxembourg,LUX,2018,23,89,NA,74,15,20.27027027027027
Luxembourg,LUX,2018,24,74,NA,77,-3,-3.896103896103896
Luxembourg,LUX,2018,25,57,NA,64,-7,-10.9375
Luxembourg,LUX,2018,26,77,NA,72,5,6.944444444444445
Luxembourg,LUX,2018,27,77,NA,72,5,6.944444444444445
Luxembourg,LUX,2018,28,63,NA,78,-15,-19.230769230769234
Luxembourg,LUX,2018,29,69,NA,73,-4,-5.47945205479452
Luxembourg,LUX,2018,30,88,NA,79,9,11.39240506329114
Luxembourg,LUX,2018,31,100,NA,76,24,31.57894736842105
Luxembourg,LUX,2018,32,95,NA,76,19,25
Luxembourg,LUX,2018,33,81,NA,75,6,8
Luxembourg,LUX,2018,34,58,NA,66,-8,-12.121212121212121
Luxembourg,LUX,2018,35,72,NA,78,-6,-7.6923076923076925
Luxembourg,LUX,2018,36,88,NA,77,11,14.285714285714285
Luxembourg,LUX,2018,37,60,NA,72,-12,-16.666666666666664
Luxembourg,LUX,2018,38,60,NA,68,-8,-11.76470588235294
Luxembourg,LUX,2018,39,84,NA,84,0,0
Luxembourg,LUX,2018,40,91,NA,80,11,13.750000000000002
Luxembourg,LUX,2018,41,90,NA,89,1,1.1235955056179776
Luxembourg,LUX,2018,42,86,NA,77,9,11.688311688311687
Luxembourg,LUX,2018,43,61,NA,75,-14,-18.666666666666668
Luxembourg,LUX,2018,44,83,NA,86,-3,-3.488372093023256
Luxembourg,LUX,2018,45,98,NA,85,13,15.294117647058824
Luxembourg,LUX,2018,46,70,NA,82,-12,-14.634146341463413
Luxembourg,LUX,2018,47,89,NA,87,2,2.2988505747126435
Luxembourg,LUX,2018,48,72,NA,78,-6,-7.6923076923076925
Luxembourg,LUX,2018,49,69,NA,84,-15,-17.857142857142858
Luxembourg,LUX,2018,50,85,NA,84,1,1.1904761904761905
Luxembourg,LUX,2018,51,92,NA,84,8,9.523809523809524
Luxembourg,LUX,2018,52,81,NA,91,-10,-10.989010989010989
Luxembourg,LUX,2019,1,98,NA,88,10,11.363636363636363
Luxembourg,LUX,2019,2,82,NA,96,-14,-14.583333333333334
Luxembourg,LUX,2019,3,81,NA,89,-8,-8.98876404494382
Luxembourg,LUX,2019,4,83,NA,88,-5,-5.681818181818182
Luxembourg,LUX,2019,5,101,NA,96,5,5.208333333333334
Luxembourg,LUX,2019,6,106,NA,96,10,10.416666666666668
Luxembourg,LUX,2019,7,112,NA,98,14,14.285714285714285
Luxembourg,LUX,2019,8,89,NA,84,5,5.952380952380952
Luxembourg,LUX,2019,9,90,NA,88,2,2.272727272727273
Luxembourg,LUX,2019,10,83,NA,100,-17,-17
Luxembourg,LUX,2019,11,78,NA,81,-3,-3.7037037037037033
Luxembourg,LUX,2019,12,83,NA,89,-6,-6.741573033707865
Luxembourg,LUX,2019,13,92,NA,86,6,6.976744186046512
Luxembourg,LUX,2019,14,77,NA,82,-5,-6.097560975609756
Luxembourg,LUX,2019,15,70,NA,71,-1,-1.4084507042253522
Luxembourg,LUX,2019,16,78,NA,79,-1,-1.2658227848101267
Luxembourg,LUX,2019,17,82,NA,75,7,9.333333333333334
Luxembourg,LUX,2019,18,81,NA,74,7,9.45945945945946
Luxembourg,LUX,2019,19,66,NA,71,-5,-7.042253521126761
Luxembourg,LUX,2019,20,77,NA,73,4,5.47945205479452
Luxembourg,LUX,2019,21,82,NA,80,2,2.5
Luxembourg,LUX,2019,22,80,NA,67,13,19.402985074626866
Luxembourg,LUX,2019,23,71,NA,74,-3,-4.054054054054054
Luxembourg,LUX,2019,24,67,NA,77,-10,-12.987012987012985
Luxembourg,LUX,2019,25,63,NA,64,-1,-1.5625
Luxembourg,LUX,2019,26,92,NA,72,20,27.77777777777778
Luxembourg,LUX,2019,27,71,NA,72,-1,-1.3888888888888888
Luxembourg,LUX,2019,28,86,NA,78,8,10.256410256410255
Luxembourg,LUX,2019,29,70,NA,73,-3,-4.10958904109589
Luxembourg,LUX,2019,30,72,NA,79,-7,-8.860759493670885
Luxembourg,LUX,2019,31,72,NA,76,-4,-5.263157894736842
Luxembourg,LUX,2019,32,82,NA,76,6,7.894736842105263
Luxembourg,LUX,2019,33,79,NA,75,4,5.333333333333334
Luxembourg,LUX,2019,34,65,NA,66,-1,-1.5151515151515151
Luxembourg,LUX,2019,35,77,NA,78,-1,-1.282051282051282
Luxembourg,LUX,2019,36,73,NA,77,-4,-5.194805194805195
Luxembourg,LUX,2019,37,78,NA,72,6,8.333333333333332
Luxembourg,LUX,2019,38,72,NA,68,4,5.88235294117647
Luxembourg,LUX,2019,39,85,NA,84,1,1.1904761904761905
Luxembourg,LUX,2019,40,83,NA,80,3,3.75
Luxembourg,LUX,2019,41,87,NA,89,-2,-2.247191011235955
Luxembourg,LUX,2019,42,62,NA,77,-15,-19.480519480519483
Luxembourg,LUX,2019,43,83,NA,75,8,10.666666666666668
Luxembourg,LUX,2019,44,103,NA,86,17,19.767441860465116
Luxembourg,LUX,2019,45,90,NA,85,5,5.88235294117647
Luxembourg,LUX,2019,46,102,NA,82,20,24.390243902439025
Luxembourg,LUX,2019,47,89,NA,87,2,2.2988505747126435
Luxembourg,LUX,2019,48,89,NA,78,11,14.102564102564102
Luxembourg,LUX,2019,49,87,NA,84,3,3.571428571428571
Luxembourg,LUX,2019,50,89,NA,84,5,5.952380952380952
Luxembourg,LUX,2019,51,83,NA,84,-1,-1.1904761904761905
Luxembourg,LUX,2019,52,95,NA,91,4,4.395604395604396
Luxembourg,LUX,2020,1,63,0,88,-25,-28.40909090909091
Luxembourg,LUX,2020,2,87,0,96,-9,-9.375
Luxembourg,LUX,2020,3,90,0,89,1,1.1235955056179776
Luxembourg,LUX,2020,4,87,0,88,-1,-1.1363636363636365
Luxembourg,LUX,2020,5,88,0,96,-8,-8.333333333333332
Luxembourg,LUX,2020,6,90,0,96,-6,-6.25
Luxembourg,LUX,2020,7,69,0,98,-29,-29.591836734693878
Luxembourg,LUX,2020,8,85,0,84,1,1.1904761904761905
Luxembourg,LUX,2020,9,74,0,88,-14,-15.909090909090908
Luxembourg,LUX,2020,10,91,0,100,-9,-9
Luxembourg,LUX,2020,11,91,1,81,10,12.345679012345679
Luxembourg,LUX,2020,12,89,7,89,0,0
Luxembourg,LUX,2020,13,112,14,86,26,30.23255813953488
Luxembourg,LUX,2020,14,90,19,82,8,9.75609756097561
Luxembourg,LUX,2020,15,116,26,71,45,63.38028169014085
Luxembourg,LUX,2020,16,89,8,79,10,12.658227848101266
Luxembourg,LUX,2020,17,84,13,75,9,12
Lettonie,LVA,2020,14,561,1,NaN,NaN,NaN
Lettonie,LVA,2020,15,491,4,NaN,NaN,NaN
Lettonie,LVA,2020,16,573,0,NaN,NaN,NaN
Lettonie,LVA,2020,17,533,8,NaN,NaN,NaN
Lettonie,LVA,2020,18,533,3,NaN,NaN,NaN
Lettonie,LVA,2020,19,578,2,NaN,NaN,NaN
Lettonie,LVA,2020,20,521,1,NaN,NaN,NaN
Lettonie,LVA,2020,21,557,3,NaN,NaN,NaN
Lettonie,LVA,2020,22,505,2,NaN,NaN,NaN
Lettonie,LVA,2020,23,504,2,NaN,NaN,NaN
Monténégro,MNE,2020,1,85,NA,NaN,NaN,NaN
Monténégro,MNE,2020,2,116,NA,NaN,NaN,NaN
Monténégro,MNE,2020,3,141,NA,NaN,NaN,NaN
Monténégro,MNE,2020,4,131,NA,NaN,NaN,NaN
Monténégro,MNE,2020,5,138,NA,NaN,NaN,NaN
Monténégro,MNE,2020,6,148,NA,NaN,NaN,NaN
Monténégro,MNE,2020,7,127,NA,NaN,NaN,NaN
Monténégro,MNE,2020,8,139,NA,NaN,NaN,NaN
Monténégro,MNE,2020,9,115,NA,NaN,NaN,NaN
Monténégro,MNE,2020,10,131,NA,NaN,NaN,NaN
Monténégro,MNE,2020,11,103,NA,NaN,NaN,NaN
Monténégro,MNE,2020,12,106,0,NaN,NaN,NaN
Monténégro,MNE,2020,13,129,1,NaN,NaN,NaN
Monténégro,MNE,2020,14,32,1,NaN,NaN,NaN
Pays-Bas,NLD,2016,1,2920,NA,3223,-303,-9.401179025752404
Pays-Bas,NLD,2016,2,3173,NA,3358,-185,-5.5092316855271
Pays-Bas,NLD,2016,3,3075,NA,3269,-194,-5.934536555521566
Pays-Bas,NLD,2016,4,3062,NA,3297,-235,-7.127691841067637
Pays-Bas,NLD,2016,5,3201,NA,3330,-129,-3.873873873873874
Pays-Bas,NLD,2016,6,3103,NA,3312,-209,-6.310386473429952
Pays-Bas,NLD,2016,7,3036,NA,3341,-305,-9.129003292427416
Pays-Bas,NLD,2016,8,3027,NA,3317,-290,-8.742839915586373
Pays-Bas,NLD,2016,9,3319,NA,3368,-49,-1.4548693586698338
Pays-Bas,NLD,2016,10,3185,NA,3376,-191,-5.657582938388626
Pays-Bas,NLD,2016,11,3151,NA,3238,-87,-2.686843730697962
Pays-Bas,NLD,2016,12,3062,NA,3078,-16,-0.5198180636777128
Pays-Bas,NLD,2016,13,3028,NA,3029,-1,-0.033014196104324864
Pays-Bas,NLD,2016,14,3037,NA,2935,102,3.475298126064736
Pays-Bas,NLD,2016,15,3010,NA,2895,115,3.9723661485319512
Pays-Bas,NLD,2016,16,2767,NA,2820,-53,-1.8794326241134751
Pays-Bas,NLD,2016,17,2751,NA,2787,-36,-1.2917115177610334
Pays-Bas,NLD,2016,18,2742,NA,2740,2,0.072992700729927
Pays-Bas,NLD,2016,19,2754,NA,2742,12,0.437636761487965
Pays-Bas,NLD,2016,20,2952,NA,2795,157,5.617173524150268
Pays-Bas,NLD,2016,21,2671,NA,2748,-77,-2.802037845705968
Pays-Bas,NLD,2016,22,2713,NA,2730,-17,-0.6227106227106227
Pays-Bas,NLD,2016,23,2682,NA,2680,2,0.0746268656716418
Pays-Bas,NLD,2016,24,2587,NA,2609,-22,-0.8432349559218091
Pays-Bas,NLD,2016,25,2620,NA,2636,-16,-0.6069802731411229
Pays-Bas,NLD,2016,26,2597,NA,2686,-89,-3.3134772896500375
Pays-Bas,NLD,2016,27,2609,NA,2689,-80,-2.9750836742283377
Pays-Bas,NLD,2016,28,2693,NA,2661,32,1.2025554302893648
Pays-Bas,NLD,2016,29,2627,NA,2647,-20,-0.7555723460521345
Pays-Bas,NLD,2016,30,2753,NA,2774,-21,-0.7570295602018745
Pays-Bas,NLD,2016,31,2542,NA,2636,-94,-3.566009104704097
Pays-Bas,NLD,2016,32,2500,NA,2632,-132,-5.015197568389058
Pays-Bas,NLD,2016,33,2558,NA,2579,-21,-0.8142690965490499
Pays-Bas,NLD,2016,34,2568,NA,2585,-17,-0.6576402321083172
Pays-Bas,NLD,2016,35,2701,NA,2646,55,2.0786092214663645
Pays-Bas,NLD,2016,36,2591,NA,2582,9,0.34856700232378
Pays-Bas,NLD,2016,37,2584,NA,2618,-34,-1.2987012987012987
Pays-Bas,NLD,2016,38,2725,NA,2682,43,1.603281133482476
Pays-Bas,NLD,2016,39,2500,NA,2654,-154,-5.802562170308968
Pays-Bas,NLD,2016,40,2665,NA,2706,-41,-1.5151515151515151
Pays-Bas,NLD,2016,41,2683,NA,2779,-96,-3.4544800287873336
Pays-Bas,NLD,2016,42,2934,NA,2814,120,4.264392324093817
Pays-Bas,NLD,2016,43,2744,NA,2740,4,0.145985401459854
Pays-Bas,NLD,2016,44,2948,NA,2835,113,3.9858906525573197
Pays-Bas,NLD,2016,45,2731,NA,2834,-103,-3.6344389555398733
Pays-Bas,NLD,2016,46,2912,NA,2912,0,0
Pays-Bas,NLD,2016,47,2902,NA,2924,-22,-0.7523939808481532
Pays-Bas,NLD,2016,48,2908,NA,2934,-26,-0.8861622358554875
Pays-Bas,NLD,2016,49,2949,NA,2989,-40,-1.3382402141184342
Pays-Bas,NLD,2016,50,3042,NA,3106,-64,-2.06052801030264
Pays-Bas,NLD,2016,51,3129,NA,3121,8,0.25632809996795897
Pays-Bas,NLD,2016,52,3072,NA,3039,33,1.085883514313919
Pays-Bas,NLD,2017,1,3568,NA,3223,345,10.704312752094323
Pays-Bas,NLD,2017,2,3637,NA,3358,279,8.308516974389518
Pays-Bas,NLD,2017,3,3487,NA,3269,218,6.66870602630774
Pays-Bas,NLD,2017,4,3626,NA,3297,329,9.978768577494693
Pays-Bas,NLD,2017,5,3574,NA,3330,244,7.327327327327328
Pays-Bas,NLD,2017,6,3446,NA,3312,134,4.045893719806763
Pays-Bas,NLD,2017,7,3417,NA,3341,76,2.2747680335228972
Pays-Bas,NLD,2017,8,3328,NA,3317,11,0.33162496231534516
Pays-Bas,NLD,2017,9,3152,NA,3368,-216,-6.413301662707839
Pays-Bas,NLD,2017,10,3054,NA,3376,-322,-9.537914691943127
Pays-Bas,NLD,2017,11,2843,NA,3238,-395,-12.198888202594194
Pays-Bas,NLD,2017,12,2778,NA,3078,-300,-9.746588693957115
Pays-Bas,NLD,2017,13,2850,NA,3029,-179,-5.90954110267415
Pays-Bas,NLD,2017,14,2764,NA,2935,-171,-5.826235093696763
Pays-Bas,NLD,2017,15,2810,NA,2895,-85,-2.936096718480138
Pays-Bas,NLD,2017,16,2713,NA,2820,-107,-3.7943262411347516
Pays-Bas,NLD,2017,17,2778,NA,2787,-9,-0.32292787944025836
Pays-Bas,NLD,2017,18,2769,NA,2740,29,1.0583941605839415
Pays-Bas,NLD,2017,19,2802,NA,2742,60,2.1881838074398248
Pays-Bas,NLD,2017,20,2801,NA,2795,6,0.2146690518783542
Pays-Bas,NLD,2017,21,2772,NA,2748,24,0.8733624454148471
Pays-Bas,NLD,2017,22,2701,NA,2730,-29,-1.0622710622710623
Pays-Bas,NLD,2017,23,2624,NA,2680,-56,-2.0895522388059704
Pays-Bas,NLD,2017,24,2643,NA,2609,34,1.303181295515523
Pays-Bas,NLD,2017,25,2627,NA,2636,-9,-0.34142640364188165
Pays-Bas,NLD,2017,26,2691,NA,2686,5,0.18615040953090098
Pays-Bas,NLD,2017,27,2697,NA,2689,8,0.29750836742283376
Pays-Bas,NLD,2017,28,2520,NA,2661,-141,-5.2987598647125145
Pays-Bas,NLD,2017,29,2674,NA,2647,27,1.0200226671703816
Pays-Bas,NLD,2017,30,2571,NA,2774,-203,-7.317952415284787
Pays-Bas,NLD,2017,31,2510,NA,2636,-126,-4.779969650986343
Pays-Bas,NLD,2017,32,2657,NA,2632,25,0.9498480243161094
Pays-Bas,NLD,2017,33,2540,NA,2579,-39,-1.5122140364482357
Pays-Bas,NLD,2017,34,2545,NA,2585,-40,-1.5473887814313347
Pays-Bas,NLD,2017,35,2576,NA,2646,-70,-2.6455026455026456
Pays-Bas,NLD,2017,36,2570,NA,2582,-12,-0.46475600309837334
Pays-Bas,NLD,2017,37,2707,NA,2618,89,3.3995416348357526
Pays-Bas,NLD,2017,38,2715,NA,2682,33,1.2304250559284116
Pays-Bas,NLD,2017,39,2669,NA,2654,15,0.5651846269781462
Pays-Bas,NLD,2017,40,2641,NA,2706,-65,-2.402069475240207
Pays-Bas,NLD,2017,41,2763,NA,2779,-16,-0.5757466714645556
Pays-Bas,NLD,2017,42,2706,NA,2814,-108,-3.8379530916844353
Pays-Bas,NLD,2017,43,2676,NA,2740,-64,-2.335766423357664
Pays-Bas,NLD,2017,44,2726,NA,2835,-109,-3.8447971781305115
Pays-Bas,NLD,2017,45,2797,NA,2834,-37,-1.305575158786168
Pays-Bas,NLD,2017,46,2916,NA,2912,4,0.13736263736263737
Pays-Bas,NLD,2017,47,2917,NA,2924,-7,-0.2393980848153215
Pays-Bas,NLD,2017,48,2886,NA,2934,-48,-1.6359918200409
Pays-Bas,NLD,2017,49,3027,NA,2989,38,1.2713282034125126
Pays-Bas,NLD,2017,50,3218,NA,3106,112,3.60592401802962
Pays-Bas,NLD,2017,51,3079,NA,3121,-42,-1.3457225248317848
Pays-Bas,NLD,2017,52,3187,NA,3039,148,4.8700230338927275
Pays-Bas,NLD,2018,1,3343,NA,3223,120,3.7232392181197644
Pays-Bas,NLD,2018,2,3359,NA,3358,1,0.02977963073257892
Pays-Bas,NLD,2018,3,3364,NA,3269,95,2.906087488528602
Pays-Bas,NLD,2018,4,3322,NA,3297,25,0.7582650894752806
Pays-Bas,NLD,2018,5,3403,NA,3330,73,2.1921921921921923
Pays-Bas,NLD,2018,6,3513,NA,3312,201,6.068840579710145
Pays-Bas,NLD,2018,7,3660,NA,3341,319,9.548039509129003
Pays-Bas,NLD,2018,8,3691,NA,3317,374,11.275248718721736
Pays-Bas,NLD,2018,9,3937,NA,3368,569,16.894299287410927
Pays-Bas,NLD,2018,10,4092,NA,3376,716,21.208530805687204
Pays-Bas,NLD,2018,11,3733,NA,3238,495,15.28721432983323
Pays-Bas,NLD,2018,12,3430,NA,3078,352,11.435997400909681
Pays-Bas,NLD,2018,13,3225,NA,3029,196,6.4707824364476725
Pays-Bas,NLD,2018,14,3040,NA,2935,105,3.577512776831346
Pays-Bas,NLD,2018,15,2860,NA,2895,-35,-1.2089810017271159
Pays-Bas,NLD,2018,16,2760,NA,2820,-60,-2.127659574468085
Pays-Bas,NLD,2018,17,2663,NA,2787,-124,-4.449228561176892
Pays-Bas,NLD,2018,18,2645,NA,2740,-95,-3.4671532846715327
Pays-Bas,NLD,2018,19,2641,NA,2742,-101,-3.683442742523705
Pays-Bas,NLD,2018,20,2606,NA,2795,-189,-6.762075134168158
Pays-Bas,NLD,2018,21,2674,NA,2748,-74,-2.692867540029112
Pays-Bas,NLD,2018,22,2776,NA,2730,46,1.684981684981685
Pays-Bas,NLD,2018,23,2679,NA,2680,-1,-0.0373134328358209
Pays-Bas,NLD,2018,24,2557,NA,2609,-52,-1.9931008049060943
Pays-Bas,NLD,2018,25,2601,NA,2636,-35,-1.3277693474962062
Pays-Bas,NLD,2018,26,2619,NA,2686,-67,-2.494415487714073
Pays-Bas,NLD,2018,27,2726,NA,2689,37,1.375976199330606
Pays-Bas,NLD,2018,28,2671,NA,2661,10,0.37579857196542654
Pays-Bas,NLD,2018,29,2704,NA,2647,57,2.153381186248583
Pays-Bas,NLD,2018,30,2767,NA,2774,-7,-0.25234318673395817
Pays-Bas,NLD,2018,31,2760,NA,2636,124,4.704097116843703
Pays-Bas,NLD,2018,32,2745,NA,2632,113,4.293313069908815
Pays-Bas,NLD,2018,33,2605,NA,2579,26,1.0081426909654905
Pays-Bas,NLD,2018,34,2612,NA,2585,27,1.0444874274661509
Pays-Bas,NLD,2018,35,2527,NA,2646,-119,-4.497354497354497
Pays-Bas,NLD,2018,36,2613,NA,2582,31,1.2006196746707978
Pays-Bas,NLD,2018,37,2539,NA,2618,-79,-3.0175706646294884
Pays-Bas,NLD,2018,38,2706,NA,2682,24,0.8948545861297539
Pays-Bas,NLD,2018,39,2696,NA,2654,42,1.5825169555388092
Pays-Bas,NLD,2018,40,2806,NA,2706,100,3.6954915003695494
Pays-Bas,NLD,2018,41,2760,NA,2779,-19,-0.6836991723641598
Pays-Bas,NLD,2018,42,2739,NA,2814,-75,-2.6652452025586353
Pays-Bas,NLD,2018,43,2671,NA,2740,-69,-2.5182481751824817
Pays-Bas,NLD,2018,44,2815,NA,2835,-20,-0.7054673721340388
Pays-Bas,NLD,2018,45,2798,NA,2834,-36,-1.2702893436838392
Pays-Bas,NLD,2018,46,2761,NA,2912,-151,-5.185439560439561
Pays-Bas,NLD,2018,47,2859,NA,2924,-65,-2.2229822161422708
Pays-Bas,NLD,2018,48,2907,NA,2934,-27,-0.9202453987730062
Pays-Bas,NLD,2018,49,2968,NA,2989,-21,-0.702576112412178
Pays-Bas,NLD,2018,50,3017,NA,3106,-89,-2.8654217643271087
Pays-Bas,NLD,2018,51,3041,NA,3121,-80,-2.56328099967959
Pays-Bas,NLD,2018,52,2901,NA,3039,-138,-4.54096742349457
Pays-Bas,NLD,2019,1,3062,NA,3223,-161,-4.99534595097735
Pays-Bas,NLD,2019,2,3262,NA,3358,-96,-2.858844550327576
Pays-Bas,NLD,2019,3,3150,NA,3269,-119,-3.640256959314775
Pays-Bas,NLD,2019,4,3178,NA,3297,-119,-3.6093418259023355
Pays-Bas,NLD,2019,5,3143,NA,3330,-187,-5.615615615615615
Pays-Bas,NLD,2019,6,3185,NA,3312,-127,-3.834541062801932
Pays-Bas,NLD,2019,7,3252,NA,3341,-89,-2.663873091888656
Pays-Bas,NLD,2019,8,3222,NA,3317,-95,-2.8640337654507086
Pays-Bas,NLD,2019,9,3066,NA,3368,-302,-8.966745843230402
Pays-Bas,NLD,2019,10,3171,NA,3376,-205,-6.072274881516588
Pays-Bas,NLD,2019,11,3227,NA,3238,-11,-0.33971587399629405
Pays-Bas,NLD,2019,12,3042,NA,3078,-36,-1.1695906432748537
Pays-Bas,NLD,2019,13,3013,NA,3029,-16,-0.5282271376691978
Pays-Bas,NLD,2019,14,2900,NA,2935,-35,-1.192504258943782
Pays-Bas,NLD,2019,15,2900,NA,2895,5,0.17271157167530224
Pays-Bas,NLD,2019,16,3040,NA,2820,220,7.801418439716312
Pays-Bas,NLD,2019,17,2957,NA,2787,170,6.099748833871547
Pays-Bas,NLD,2019,18,2806,NA,2740,66,2.408759124087591
Pays-Bas,NLD,2019,19,2771,NA,2742,29,1.0576221735959153
Pays-Bas,NLD,2019,20,2821,NA,2795,26,0.9302325581395349
Pays-Bas,NLD,2019,21,2873,NA,2748,125,4.548762736535663
Pays-Bas,NLD,2019,22,2732,NA,2730,2,0.07326007326007326
Pays-Bas,NLD,2019,23,2736,NA,2680,56,2.0895522388059704
Pays-Bas,NLD,2019,24,2650,NA,2609,41,1.5714833269451896
Pays-Bas,NLD,2019,25,2694,NA,2636,58,2.2003034901365703
Pays-Bas,NLD,2019,26,2835,NA,2686,149,5.547282204020849
Pays-Bas,NLD,2019,27,2725,NA,2689,36,1.338787653402752
Pays-Bas,NLD,2019,28,2760,NA,2661,99,3.720405862457723
Pays-Bas,NLD,2019,29,2584,NA,2647,-63,-2.3800528900642237
Pays-Bas,NLD,2019,30,3007,NA,2774,233,8.39942321557318
Pays-Bas,NLD,2019,31,2731,NA,2636,95,3.6039453717754175
Pays-Bas,NLD,2019,32,2628,NA,2632,-4,-0.1519756838905775
Pays-Bas,NLD,2019,33,2612,NA,2579,33,1.2795657231485071
Pays-Bas,NLD,2019,34,2615,NA,2585,30,1.160541586073501
Pays-Bas,NLD,2019,35,2782,NA,2646,136,5.139833711262283
Pays-Bas,NLD,2019,36,2555,NA,2582,-27,-1.0457010069713402
Pays-Bas,NLD,2019,37,2640,NA,2618,22,0.8403361344537815
Pays-Bas,NLD,2019,38,2580,NA,2682,-102,-3.803131991051454
Pays-Bas,NLD,2019,39,2753,NA,2654,99,3.730218538055765
Pays-Bas,NLD,2019,40,2713,NA,2706,7,0.2586844050258684
Pays-Bas,NLD,2019,41,2911,NA,2779,132,4.749910039582584
Pays-Bas,NLD,2019,42,2877,NA,2814,63,2.2388059701492535
Pays-Bas,NLD,2019,43,2867,NA,2740,127,4.635036496350365
Pays-Bas,NLD,2019,44,2852,NA,2835,17,0.599647266313933
Pays-Bas,NLD,2019,45,3011,NA,2834,177,6.245589273112209
Pays-Bas,NLD,2019,46,3057,NA,2912,145,4.979395604395604
Pays-Bas,NLD,2019,47,3019,NA,2924,95,3.248974008207935
Pays-Bas,NLD,2019,48,3037,NA,2934,103,3.5105657805044306
Pays-Bas,NLD,2019,49,3013,NA,2989,24,0.8029441284710606
Pays-Bas,NLD,2019,50,3148,NA,3106,42,1.3522215067611076
Pays-Bas,NLD,2019,51,3235,NA,3121,114,3.6526754245434154
Pays-Bas,NLD,2019,52,2997,NA,3039,-42,-1.3820335636722607
Pays-Bas,NLD,2020,1,3102,0,3223,-121,-3.754266211604096
Pays-Bas,NLD,2020,2,3364,0,3358,6,0.1786777843954735
Pays-Bas,NLD,2020,3,3153,0,3269,-116,-3.5484857754665033
Pays-Bas,NLD,2020,4,3042,0,3297,-255,-7.734303912647862
Pays-Bas,NLD,2020,5,3160,0,3330,-170,-5.105105105105105
Pays-Bas,NLD,2020,6,3191,0,3312,-121,-3.6533816425120778
Pays-Bas,NLD,2020,7,3197,0,3341,-144,-4.310086800359174
Pays-Bas,NLD,2020,8,2957,0,3317,-360,-10.853180584865843
Pays-Bas,NLD,2020,9,3093,0,3368,-275,-8.165083135391923
Pays-Bas,NLD,2020,10,3097,3,3376,-279,-8.264218009478673
Pays-Bas,NLD,2020,11,3215,21,3238,-23,-0.7103150092649784
Pays-Bas,NLD,2020,12,3609,189,3078,531,17.251461988304094
Pays-Bas,NLD,2020,13,4452,651,3029,1423,46.97920105645427
Pays-Bas,NLD,2020,14,5080,1003,2935,2145,73.08347529812606
Pays-Bas,NLD,2020,15,4972,956,2895,2077,71.74438687392055
Pays-Bas,NLD,2020,16,4293,928,2820,1473,52.234042553191486
Pays-Bas,NLD,2020,17,3896,767,2787,1109,39.7918909221385
Pays-Bas,NLD,2020,18,3370,564,2740,630,22.99270072992701
Pays-Bas,NLD,2020,19,2969,374,2742,227,8.278628738147338
Pays-Bas,NLD,2020,20,2756,238,2795,-39,-1.3953488372093024
Pays-Bas,NLD,2020,21,2738,136,2748,-10,-0.363901018922853
Norvège,NOR,2016,1,870,NA,921,-51,-5.537459283387622
Norvège,NOR,2016,2,864,NA,903,-39,-4.318936877076411
Norvège,NOR,2016,3,939,NA,906,33,3.642384105960265
Norvège,NOR,2016,4,937,NA,874,63,7.208237986270023
Norvège,NOR,2016,5,881,NA,891,-10,-1.122334455667789
Norvège,NOR,2016,6,852,NA,856,-4,-0.46728971962616817
Norvège,NOR,2016,7,826,NA,878,-52,-5.922551252847381
Norvège,NOR,2016,8,764,NA,852,-88,-10.328638497652582
Norvège,NOR,2016,9,873,NA,866,7,0.8083140877598153
Norvège,NOR,2016,10,762,NA,842,-80,-9.501187648456057
Norvège,NOR,2016,11,798,NA,826,-28,-3.389830508474576
Norvège,NOR,2016,12,802,NA,825,-23,-2.7878787878787876
Norvège,NOR,2016,13,759,NA,778,-19,-2.442159383033419
Norvège,NOR,2016,14,802,NA,803,-1,-0.12453300124533001
Norvège,NOR,2016,15,773,NA,783,-10,-1.277139208173691
Norvège,NOR,2016,16,756,NA,763,-7,-0.9174311926605505
Norvège,NOR,2016,17,755,NA,788,-33,-4.187817258883249
Norvège,NOR,2016,18,748,NA,756,-8,-1.0582010582010581
Norvège,NOR,2016,19,711,NA,738,-27,-3.6585365853658534
Norvège,NOR,2016,20,776,NA,729,47,6.447187928669409
Norvège,NOR,2016,21,713,NA,720,-7,-0.9722222222222222
Norvège,NOR,2016,22,679,NA,713,-34,-4.768583450210379
Norvège,NOR,2016,23,669,NA,703,-34,-4.836415362731152
Norvège,NOR,2016,24,729,NA,717,12,1.6736401673640167
Norvège,NOR,2016,25,725,NA,727,-2,-0.2751031636863824
Norvège,NOR,2016,26,678,NA,730,-52,-7.123287671232877
Norvège,NOR,2016,27,756,NA,756,0,0
Norvège,NOR,2016,28,734,NA,724,10,1.3812154696132597
Norvège,NOR,2016,29,685,NA,724,-39,-5.386740331491713
Norvège,NOR,2016,30,721,NA,736,-15,-2.0380434782608696
Norvège,NOR,2016,31,709,NA,701,8,1.1412268188302426
Norvège,NOR,2016,32,739,NA,723,16,2.2130013831258646
Norvège,NOR,2016,33,717,NA,712,5,0.7022471910112359
Norvège,NOR,2016,34,684,NA,714,-30,-4.201680672268908
Norvège,NOR,2016,35,723,NA,737,-14,-1.8995929443690638
Norvège,NOR,2016,36,759,NA,719,40,5.563282336578582
Norvège,NOR,2016,37,714,NA,708,6,0.847457627118644
Norvège,NOR,2016,38,681,NA,713,-32,-4.488078541374474
Norvège,NOR,2016,39,740,NA,746,-6,-0.8042895442359249
Norvège,NOR,2016,40,741,NA,722,19,2.631578947368421
Norvège,NOR,2016,41,731,NA,749,-18,-2.403204272363151
Norvège,NOR,2016,42,786,NA,751,35,4.660452729693742
Norvège,NOR,2016,43,773,NA,764,9,1.1780104712041886
Norvège,NOR,2016,44,688,NA,756,-68,-8.994708994708994
Norvège,NOR,2016,45,810,NA,769,41,5.331599479843954
Norvège,NOR,2016,46,818,NA,790,28,3.5443037974683547
Norvège,NOR,2016,47,855,NA,788,67,8.50253807106599
Norvège,NOR,2016,48,789,NA,785,4,0.5095541401273885
Norvège,NOR,2016,49,819,NA,830,-11,-1.3253012048192772
Norvège,NOR,2016,50,918,NA,825,93,11.272727272727273
Norvège,NOR,2016,51,923,NA,848,75,8.84433962264151
Norvège,NOR,2016,52,982,NA,887,95,10.710259301014656
Norvège,NOR,2017,1,1006,NA,921,85,9.229098805646037
Norvège,NOR,2017,2,1048,NA,903,145,16.057585825027683
Norvège,NOR,2017,3,928,NA,906,22,2.4282560706401766
Norvège,NOR,2017,4,866,NA,874,-8,-0.9153318077803204
Norvège,NOR,2017,5,914,NA,891,23,2.581369248035915
Norvège,NOR,2017,6,823,NA,856,-33,-3.8551401869158877
Norvège,NOR,2017,7,845,NA,878,-33,-3.758542141230068
Norvège,NOR,2017,8,898,NA,852,46,5.39906103286385
Norvège,NOR,2017,9,863,NA,866,-3,-0.3464203233256351
Norvège,NOR,2017,10,822,NA,842,-20,-2.375296912114014
Norvège,NOR,2017,11,804,NA,826,-22,-2.663438256658596
Norvège,NOR,2017,12,788,NA,825,-37,-4.484848484848484
Norvège,NOR,2017,13,756,NA,778,-22,-2.827763496143959
Norvège,NOR,2017,14,809,NA,803,6,0.7471980074719801
Norvège,NOR,2017,15,776,NA,783,-7,-0.8939974457215836
Norvège,NOR,2017,16,758,NA,763,-5,-0.655307994757536
Norvège,NOR,2017,17,816,NA,788,28,3.5532994923857872
Norvège,NOR,2017,18,745,NA,756,-11,-1.455026455026455
Norvège,NOR,2017,19,733,NA,738,-5,-0.6775067750677507
Norvège,NOR,2017,20,694,NA,729,-35,-4.801097393689986
Norvège,NOR,2017,21,735,NA,720,15,2.083333333333333
Norvège,NOR,2017,22,688,NA,713,-25,-3.506311360448808
Norvège,NOR,2017,23,724,NA,703,21,2.987197724039829
Norvège,NOR,2017,24,732,NA,717,15,2.092050209205021
Norvège,NOR,2017,25,757,NA,727,30,4.126547455295736
Norvège,NOR,2017,26,733,NA,730,3,0.410958904109589
Norvège,NOR,2017,27,756,NA,756,0,0
Norvège,NOR,2017,28,694,NA,724,-30,-4.143646408839778
Norvège,NOR,2017,29,748,NA,724,24,3.314917127071823
Norvège,NOR,2017,30,728,NA,736,-8,-1.0869565217391304
Norvège,NOR,2017,31,691,NA,701,-10,-1.4265335235378032
Norvège,NOR,2017,32,742,NA,723,19,2.627939142461964
Norvège,NOR,2017,33,704,NA,712,-8,-1.1235955056179776
Norvège,NOR,2017,34,739,NA,714,25,3.5014005602240896
Norvège,NOR,2017,35,730,NA,737,-7,-0.9497964721845319
Norvège,NOR,2017,36,708,NA,719,-11,-1.52990264255911
Norvège,NOR,2017,37,704,NA,708,-4,-0.5649717514124294
Norvège,NOR,2017,38,697,NA,713,-16,-2.244039270687237
Norvège,NOR,2017,39,713,NA,746,-33,-4.423592493297587
Norvège,NOR,2017,40,733,NA,722,11,1.5235457063711912
Norvège,NOR,2017,41,764,NA,749,15,2.0026702269692924
Norvège,NOR,2017,42,693,NA,751,-58,-7.723035952063914
Norvège,NOR,2017,43,792,NA,764,28,3.664921465968586
Norvège,NOR,2017,44,746,NA,756,-10,-1.3227513227513228
Norvège,NOR,2017,45,704,NA,769,-65,-8.452535760728217
Norvège,NOR,2017,46,760,NA,790,-30,-3.79746835443038
Norvège,NOR,2017,47,791,NA,788,3,0.3807106598984772
Norvège,NOR,2017,48,770,NA,785,-15,-1.910828025477707
Norvège,NOR,2017,49,832,NA,830,2,0.24096385542168677
Norvège,NOR,2017,50,844,NA,825,19,2.3030303030303028
Norvège,NOR,2017,51,897,NA,848,49,5.778301886792453
Norvège,NOR,2017,52,891,NA,887,4,0.4509582863585118
Norvège,NOR,2018,1,938,NA,921,17,1.8458197611292075
Norvège,NOR,2018,2,872,NA,903,-31,-3.433001107419712
Norvège,NOR,2018,3,945,NA,906,39,4.304635761589404
Norvège,NOR,2018,4,857,NA,874,-17,-1.9450800915331807
Norvège,NOR,2018,5,881,NA,891,-10,-1.122334455667789
Norvège,NOR,2018,6,904,NA,856,48,5.607476635514018
Norvège,NOR,2018,7,927,NA,878,49,5.5808656036446465
Norvège,NOR,2018,8,917,NA,852,65,7.629107981220658
Norvège,NOR,2018,9,907,NA,866,41,4.734411085450346
Norvège,NOR,2018,10,950,NA,842,108,12.826603325415679
Norvège,NOR,2018,11,867,NA,826,41,4.963680387409201
Norvège,NOR,2018,12,905,NA,825,80,9.696969696969697
Norvège,NOR,2018,13,807,NA,778,29,3.7275064267352187
Norvège,NOR,2018,14,819,NA,803,16,1.9925280199252802
Norvège,NOR,2018,15,827,NA,783,44,5.61941251596424
Norvège,NOR,2018,16,778,NA,763,15,1.9659239842726082
Norvège,NOR,2018,17,781,NA,788,-7,-0.8883248730964468
Norvège,NOR,2018,18,756,NA,756,0,0
Norvège,NOR,2018,19,738,NA,738,0,0
Norvège,NOR,2018,20,714,NA,729,-15,-2.05761316872428
Norvège,NOR,2018,21,692,NA,720,-28,-3.888888888888889
Norvège,NOR,2018,22,757,NA,713,44,6.171107994389901
Norvège,NOR,2018,23,713,NA,703,10,1.422475106685633
Norvège,NOR,2018,24,671,NA,717,-46,-6.4156206415620645
Norvège,NOR,2018,25,703,NA,727,-24,-3.3012379642365883
Norvège,NOR,2018,26,741,NA,730,11,1.5068493150684932
Norvège,NOR,2018,27,775,NA,756,19,2.513227513227513
Norvège,NOR,2018,28,737,NA,724,13,1.7955801104972375
Norvège,NOR,2018,29,720,NA,724,-4,-0.5524861878453038
Norvège,NOR,2018,30,773,NA,736,37,5.0271739130434785
Norvège,NOR,2018,31,677,NA,701,-24,-3.4236804564907275
Norvège,NOR,2018,32,705,NA,723,-18,-2.4896265560165975
Norvège,NOR,2018,33,694,NA,712,-18,-2.528089887640449
Norvège,NOR,2018,34,754,NA,714,40,5.602240896358544
Norvège,NOR,2018,35,715,NA,737,-22,-2.9850746268656714
Norvège,NOR,2018,36,694,NA,719,-25,-3.477051460361613
Norvège,NOR,2018,37,705,NA,708,-3,-0.423728813559322
Norvège,NOR,2018,38,720,NA,713,7,0.9817671809256662
Norvège,NOR,2018,39,712,NA,746,-34,-4.557640750670242
Norvège,NOR,2018,40,701,NA,722,-21,-2.9085872576177287
Norvège,NOR,2018,41,714,NA,749,-35,-4.672897196261682
Norvège,NOR,2018,42,744,NA,751,-7,-0.9320905459387484
Norvège,NOR,2018,43,696,NA,764,-68,-8.900523560209423
Norvège,NOR,2018,44,814,NA,756,58,7.671957671957672
Norvège,NOR,2018,45,776,NA,769,7,0.9102730819245773
Norvège,NOR,2018,46,736,NA,790,-54,-6.8354430379746836
Norvège,NOR,2018,47,720,NA,788,-68,-8.629441624365482
Norvège,NOR,2018,48,802,NA,785,17,2.1656050955414012
Norvège,NOR,2018,49,821,NA,830,-9,-1.0843373493975903
Norvège,NOR,2018,50,759,NA,825,-66,-8
Norvège,NOR,2018,51,802,NA,848,-46,-5.4245283018867925
Norvège,NOR,2018,52,871,NA,887,-16,-1.8038331454340473
Norvège,NOR,2019,1,871,NA,921,-50,-5.428881650380022
Norvège,NOR,2019,2,827,NA,903,-76,-8.416389811738648
Norvège,NOR,2019,3,811,NA,906,-95,-10.485651214128035
Norvège,NOR,2019,4,834,NA,874,-40,-4.576659038901601
Norvège,NOR,2019,5,889,NA,891,-2,-0.22446689113355783
Norvège,NOR,2019,6,843,NA,856,-13,-1.5186915887850467
Norvège,NOR,2019,7,914,NA,878,36,4.100227790432802
Norvège,NOR,2019,8,828,NA,852,-24,-2.8169014084507045
Norvège,NOR,2019,9,819,NA,866,-47,-5.427251732101617
Norvège,NOR,2019,10,833,NA,842,-9,-1.0688836104513064
Norvège,NOR,2019,11,836,NA,826,10,1.2106537530266344
Norvège,NOR,2019,12,805,NA,825,-20,-2.4242424242424243
Norvège,NOR,2019,13,790,NA,778,12,1.5424164524421593
Norvège,NOR,2019,14,781,NA,803,-22,-2.73972602739726
Norvège,NOR,2019,15,757,NA,783,-26,-3.3205619412515963
Norvège,NOR,2019,16,761,NA,763,-2,-0.2621231979030144
Norvège,NOR,2019,17,799,NA,788,11,1.3959390862944163
Norvège,NOR,2019,18,773,NA,756,17,2.2486772486772484
Norvège,NOR,2019,19,772,NA,738,34,4.607046070460704
Norvège,NOR,2019,20,732,NA,729,3,0.411522633744856
Norvège,NOR,2019,21,741,NA,720,21,2.9166666666666665
Norvège,NOR,2019,22,728,NA,713,15,2.1037868162692845
Norvège,NOR,2019,23,707,NA,703,4,0.5689900426742532
Norvège,NOR,2019,24,735,NA,717,18,2.510460251046025
Norvège,NOR,2019,25,723,NA,727,-4,-0.5502063273727648
Norvège,NOR,2019,26,767,NA,730,37,5.068493150684931
Norvège,NOR,2019,27,735,NA,756,-21,-2.7777777777777777
Norvège,NOR,2019,28,732,NA,724,8,1.1049723756906076
Norvège,NOR,2019,29,741,NA,724,17,2.3480662983425415
Norvège,NOR,2019,30,721,NA,736,-15,-2.0380434782608696
Norvège,NOR,2019,31,727,NA,701,26,3.7089871611982885
Norvège,NOR,2019,32,705,NA,723,-18,-2.4896265560165975
Norvège,NOR,2019,33,733,NA,712,21,2.9494382022471908
Norvège,NOR,2019,34,677,NA,714,-37,-5.182072829131653
Norvège,NOR,2019,35,779,NA,737,42,5.698778833107191
Norvège,NOR,2019,36,714,NA,719,-5,-0.6954102920723227
Norvège,NOR,2019,37,707,NA,708,-1,-0.14124293785310735
Norvège,NOR,2019,38,755,NA,713,42,5.890603085553997
Norvège,NOR,2019,39,818,NA,746,72,9.651474530831099
Norvège,NOR,2019,40,711,NA,722,-11,-1.5235457063711912
Norvège,NOR,2019,41,786,NA,749,37,4.939919893190922
Norvège,NOR,2019,42,782,NA,751,31,4.1278295605858855
Norvège,NOR,2019,43,793,NA,764,29,3.7958115183246073
Norvège,NOR,2019,44,774,NA,756,18,2.380952380952381
Norvège,NOR,2019,45,786,NA,769,17,2.2106631989596877
Norvège,NOR,2019,46,846,NA,790,56,7.088607594936709
Norvège,NOR,2019,47,784,NA,788,-4,-0.5076142131979695
Norvège,NOR,2019,48,778,NA,785,-7,-0.89171974522293
Norvège,NOR,2019,49,850,NA,830,20,2.4096385542168677
Norvège,NOR,2019,50,780,NA,825,-45,-5.454545454545454
Norvège,NOR,2019,51,772,NA,848,-76,-8.962264150943396
Norvège,NOR,2019,52,804,NA,887,-83,-9.357384441939121
Norvège,NOR,2020,1,860,0,921,-61,-6.623235613463627
Norvège,NOR,2020,2,948,0,903,45,4.983388704318937
Norvège,NOR,2020,3,835,0,906,-71,-7.836644591611479
Norvège,NOR,2020,4,862,0,874,-12,-1.3729977116704806
Norvège,NOR,2020,5,796,0,891,-95,-10.662177328843995
Norvège,NOR,2020,6,796,0,856,-60,-7.009345794392523
Norvège,NOR,2020,7,845,0,878,-33,-3.758542141230068
Norvège,NOR,2020,8,821,0,852,-31,-3.6384976525821595
Norvège,NOR,2020,9,832,0,866,-34,-3.9260969976905313
Norvège,NOR,2020,10,799,0,842,-43,-5.10688836104513
Norvège,NOR,2020,11,758,3,826,-68,-8.232445520581114
Norvège,NOR,2020,12,734,5,825,-91,-11.030303030303031
Norvège,NOR,2020,13,722,18,778,-56,-7.197943444730077
Norvège,NOR,2020,14,645,33,803,-158,-19.676214196762142
Norvège,NOR,2020,15,672,55,783,-111,-14.17624521072797
Norvège,NOR,2020,16,794,40,763,31,4.062909567496723
Norvège,NOR,2020,17,756,39,788,-32,-4.060913705583756
Norvège,NOR,2020,18,724,15,756,-32,-4.232804232804233
Norvège,NOR,2020,19,707,16,738,-31,-4.200542005420054
Norvège,NOR,2020,20,613,9,729,-116,-15.912208504801098
Norvège,NOR,2020,21,550,2,720,-170,-23.61111111111111
Norvège,NOR,2020,22,476,1,713,-237,-33.2398316970547
Portugal,PRT,2016,1,2321,NA,2790,-469,-16.810035842293907
Portugal,PRT,2016,2,2332,NA,2746,-414,-15.076474872541878
Portugal,PRT,2016,3,2456,NA,2782,-326,-11.718188353702372
Portugal,PRT,2016,4,2332,NA,2760,-428,-15.507246376811596
Portugal,PRT,2016,5,2271,NA,2631,-360,-13.683010262257698
Portugal,PRT,2016,6,2351,NA,2592,-241,-9.297839506172838
Portugal,PRT,2016,7,2345,NA,2560,-215,-8.3984375
Portugal,PRT,2016,8,2296,NA,2464,-168,-6.8181818181818175
Portugal,PRT,2016,9,2391,NA,2404,-13,-0.5407653910149751
Portugal,PRT,2016,10,2380,NA,2311,69,2.98572046733016
Portugal,PRT,2016,11,2288,NA,2267,21,0.9263343625937362
Portugal,PRT,2016,12,2271,NA,2194,77,3.509571558796718
Portugal,PRT,2016,13,2214,NA,2180,34,1.5596330275229358
Portugal,PRT,2016,14,2225,NA,2187,38,1.7375400091449476
Portugal,PRT,2016,15,2166,NA,2152,14,0.6505576208178439
Portugal,PRT,2016,16,1989,NA,2027,-38,-1.8746916625555006
Portugal,PRT,2016,17,2025,NA,2032,-7,-0.34448818897637795
Portugal,PRT,2016,18,1954,NA,2014,-60,-2.9791459781529297
Portugal,PRT,2016,19,1849,NA,1913,-64,-3.34553058024046
Portugal,PRT,2016,20,2045,NA,1969,76,3.8598273235144744
Portugal,PRT,2016,21,1971,NA,1948,23,1.1806981519507187
Portugal,PRT,2016,22,1983,NA,1907,76,3.985317252228631
Portugal,PRT,2016,23,1906,NA,1888,18,0.9533898305084746
Portugal,PRT,2016,24,1799,NA,1892,-93,-4.915433403805497
Portugal,PRT,2016,25,1916,NA,2019,-103,-5.101535413571074
Portugal,PRT,2016,26,1893,NA,1883,10,0.5310674455655868
Portugal,PRT,2016,27,1913,NA,1839,74,4.023926046764546
Portugal,PRT,2016,28,1934,NA,1852,82,4.427645788336933
Portugal,PRT,2016,29,1958,NA,1846,112,6.067172264355363
Portugal,PRT,2016,30,2054,NA,1880,174,9.25531914893617
Portugal,PRT,2016,31,1864,NA,1929,-65,-3.3696215655780195
Portugal,PRT,2016,32,2091,NA,1967,124,6.304016268429081
Portugal,PRT,2016,33,1879,NA,1842,37,2.008686210640608
Portugal,PRT,2016,34,1914,NA,1943,-29,-1.4925373134328357
Portugal,PRT,2016,35,1873,NA,1808,65,3.5951327433628317
Portugal,PRT,2016,36,1864,NA,1854,10,0.5393743257820928
Portugal,PRT,2016,37,1707,NA,1778,-71,-3.9932508436445446
Portugal,PRT,2016,38,1835,NA,1848,-13,-0.7034632034632035
Portugal,PRT,2016,39,1852,NA,1862,-10,-0.5370569280343717
Portugal,PRT,2016,40,1856,NA,1908,-52,-2.7253668763102725
Portugal,PRT,2016,41,1879,NA,1888,-9,-0.4766949152542373
Portugal,PRT,2016,42,2026,NA,1970,56,2.8426395939086295
Portugal,PRT,2016,43,1971,NA,2008,-37,-1.8426294820717133
Portugal,PRT,2016,44,1939,NA,2008,-69,-3.436254980079681
Portugal,PRT,2016,45,2040,NA,2043,-3,-0.14684287812041116
Portugal,PRT,2016,46,2127,NA,2132,-5,-0.23452157598499063
Portugal,PRT,2016,47,2197,NA,2167,30,1.3844023996308261
Portugal,PRT,2016,48,2388,NA,2238,150,6.702412868632708
Portugal,PRT,2016,49,2363,NA,2276,87,3.8224956063268896
Portugal,PRT,2016,50,2526,NA,2350,176,7.48936170212766
Portugal,PRT,2016,51,2809,NA,2463,346,14.047909053999188
Portugal,PRT,2016,52,3200,NA,2657,543,20.436582611968383
Portugal,PRT,2017,1,3366,NA,2790,576,20.64516129032258
Portugal,PRT,2017,2,2967,NA,2746,221,8.048069919883467
Portugal,PRT,2017,3,2880,NA,2782,98,3.5226455787203452
Portugal,PRT,2017,4,2995,NA,2760,235,8.51449275362319
Portugal,PRT,2017,5,2736,NA,2631,105,3.990877993158495
Portugal,PRT,2017,6,2453,NA,2592,-139,-5.362654320987654
Portugal,PRT,2017,7,2369,NA,2560,-191,-7.460937500000001
Portugal,PRT,2017,8,2237,NA,2464,-227,-9.212662337662337
Portugal,PRT,2017,9,2129,NA,2404,-275,-11.43926788685524
Portugal,PRT,2017,10,2149,NA,2311,-162,-7.009952401557768
Portugal,PRT,2017,11,2151,NA,2267,-116,-5.116894574327305
Portugal,PRT,2017,12,2074,NA,2194,-120,-5.469462169553328
Portugal,PRT,2017,13,2015,NA,2180,-165,-7.568807339449542
Portugal,PRT,2017,14,2071,NA,2187,-116,-5.304069501600366
Portugal,PRT,2017,15,2033,NA,2152,-119,-5.529739776951673
Portugal,PRT,2017,16,1825,NA,2027,-202,-9.965466206216082
Portugal,PRT,2017,17,1902,NA,2032,-130,-6.397637795275591
Portugal,PRT,2017,18,2011,NA,2014,-3,-0.14895729890764647
Portugal,PRT,2017,19,1846,NA,1913,-67,-3.5023523261892313
Portugal,PRT,2017,20,1833,NA,1969,-136,-6.9070594210259015
Portugal,PRT,2017,21,1922,NA,1948,-26,-1.3347022587268993
Portugal,PRT,2017,22,1815,NA,1907,-92,-4.824331410592554
Portugal,PRT,2017,23,1826,NA,1888,-62,-3.283898305084746
Portugal,PRT,2017,24,1969,NA,1892,77,4.069767441860465
Portugal,PRT,2017,25,2139,NA,2019,120,5.943536404160475
Portugal,PRT,2017,26,1784,NA,1883,-99,-5.25756771109931
Portugal,PRT,2017,27,1796,NA,1839,-43,-2.3382272974442633
Portugal,PRT,2017,28,1806,NA,1852,-46,-2.4838012958963285
Portugal,PRT,2017,29,1790,NA,1846,-56,-3.0335861321776814
Portugal,PRT,2017,30,1799,NA,1880,-81,-4.308510638297872
Portugal,PRT,2017,31,1759,NA,1929,-170,-8.812856402280975
Portugal,PRT,2017,32,1739,NA,1967,-228,-11.591255719369599
Portugal,PRT,2017,33,1781,NA,1842,-61,-3.3116178067318134
Portugal,PRT,2017,34,1960,NA,1943,17,0.8749356664951106
Portugal,PRT,2017,35,1711,NA,1808,-97,-5.365044247787611
Portugal,PRT,2017,36,1783,NA,1854,-71,-3.8295577130528584
Portugal,PRT,2017,37,1801,NA,1778,23,1.2935883014623173
Portugal,PRT,2017,38,1793,NA,1848,-55,-2.976190476190476
Portugal,PRT,2017,39,1945,NA,1862,83,4.457572502685284
Portugal,PRT,2017,40,1983,NA,1908,75,3.930817610062893
Portugal,PRT,2017,41,1877,NA,1888,-11,-0.5826271186440678
Portugal,PRT,2017,42,2004,NA,1970,34,1.7258883248730965
Portugal,PRT,2017,43,1932,NA,2008,-76,-3.7848605577689245
Portugal,PRT,2017,44,1918,NA,2008,-90,-4.482071713147411
Portugal,PRT,2017,45,1910,NA,2043,-133,-6.510034263338229
Portugal,PRT,2017,46,2161,NA,2132,29,1.3602251407129455
Portugal,PRT,2017,47,2168,NA,2167,1,0.046146746654360866
Portugal,PRT,2017,48,2193,NA,2238,-45,-2.0107238605898123
Portugal,PRT,2017,49,2465,NA,2276,189,8.304042179261863
Portugal,PRT,2017,50,2455,NA,2350,105,4.468085106382979
Portugal,PRT,2017,51,2510,NA,2463,47,1.9082419813235891
Portugal,PRT,2017,52,2747,NA,2657,90,3.387278885961611
Portugal,PRT,2018,1,2851,NA,2790,61,2.186379928315412
Portugal,PRT,2018,2,2803,NA,2746,57,2.0757465404224327
Portugal,PRT,2018,3,2805,NA,2782,23,0.8267433501078361
Portugal,PRT,2018,4,2693,NA,2760,-67,-2.427536231884058
Portugal,PRT,2018,5,2619,NA,2631,-12,-0.45610034207525657
Portugal,PRT,2018,6,2783,NA,2592,191,7.368827160493827
Portugal,PRT,2018,7,2815,NA,2560,255,9.9609375
Portugal,PRT,2018,8,2777,NA,2464,313,12.702922077922077
Portugal,PRT,2018,9,2656,NA,2404,252,10.482529118136439
Portugal,PRT,2018,10,2387,NA,2311,76,3.288619645175249
Portugal,PRT,2018,11,2371,NA,2267,104,4.58756065284517
Portugal,PRT,2018,12,2234,NA,2194,40,1.8231540565177755
Portugal,PRT,2018,13,2356,NA,2180,176,8.073394495412845
Portugal,PRT,2018,14,2354,NA,2187,167,7.6360310928212165
Portugal,PRT,2018,15,2276,NA,2152,124,5.762081784386617
Portugal,PRT,2018,16,2197,NA,2027,170,8.386778490379871
Portugal,PRT,2018,17,2117,NA,2032,85,4.183070866141732
Portugal,PRT,2018,18,2012,NA,2014,-2,-0.09930486593843098
Portugal,PRT,2018,19,1970,NA,1913,57,2.9796131730266597
Portugal,PRT,2018,20,2066,NA,1969,97,4.926358557643474
Portugal,PRT,2018,21,1982,NA,1948,34,1.7453798767967144
Portugal,PRT,2018,22,1883,NA,1907,-24,-1.2585212375458836
Portugal,PRT,2018,23,1977,NA,1888,89,4.713983050847458
Portugal,PRT,2018,24,1928,NA,1892,36,1.9027484143763214
Portugal,PRT,2018,25,2104,NA,2019,85,4.210004952947004
Portugal,PRT,2018,26,1936,NA,1883,53,2.8146574614976103
Portugal,PRT,2018,27,1765,NA,1839,-74,-4.023926046764546
Portugal,PRT,2018,28,1771,NA,1852,-81,-4.37365010799136
Portugal,PRT,2018,29,1816,NA,1846,-30,-1.6251354279523293
Portugal,PRT,2018,30,1824,NA,1880,-56,-2.9787234042553195
Portugal,PRT,2018,31,2250,NA,1929,321,16.640746500777606
Portugal,PRT,2018,32,2199,NA,1967,232,11.794611082867311
Portugal,PRT,2018,33,1939,NA,1842,97,5.266015200868622
Portugal,PRT,2018,34,1960,NA,1943,17,0.8749356664951106
Portugal,PRT,2018,35,1766,NA,1808,-42,-2.3230088495575223
Portugal,PRT,2018,36,1837,NA,1854,-17,-0.9169363538295576
Portugal,PRT,2018,37,1796,NA,1778,18,1.0123734533183353
Portugal,PRT,2018,38,1867,NA,1848,19,1.0281385281385282
Portugal,PRT,2018,39,1828,NA,1862,-34,-1.8259935553168638
Portugal,PRT,2018,40,1890,NA,1908,-18,-0.9433962264150944
Portugal,PRT,2018,41,1935,NA,1888,47,2.489406779661017
Portugal,PRT,2018,42,1943,NA,1970,-27,-1.3705583756345179
Portugal,PRT,2018,43,1996,NA,2008,-12,-0.5976095617529881
Portugal,PRT,2018,44,2043,NA,2008,35,1.743027888446215
Portugal,PRT,2018,45,2124,NA,2043,81,3.9647577092511015
Portugal,PRT,2018,46,2093,NA,2132,-39,-1.8292682926829267
Portugal,PRT,2018,47,2071,NA,2167,-96,-4.430087678818643
Portugal,PRT,2018,48,2132,NA,2238,-106,-4.736371760500447
Portugal,PRT,2018,49,2150,NA,2276,-126,-5.536028119507909
Portugal,PRT,2018,50,2129,NA,2350,-221,-9.404255319148938
Portugal,PRT,2018,51,2249,NA,2463,-214,-8.688591149005278
Portugal,PRT,2018,52,2367,NA,2657,-290,-10.914565299209634
Portugal,PRT,2019,1,2621,NA,2790,-169,-6.057347670250897
Portugal,PRT,2019,2,2884,NA,2746,138,5.025491624180627
Portugal,PRT,2019,3,2985,NA,2782,203,7.296908698777857
Portugal,PRT,2019,4,3021,NA,2760,261,9.456521739130434
Portugal,PRT,2019,5,2899,NA,2631,268,10.186240973014064
Portugal,PRT,2019,6,2779,NA,2592,187,7.214506172839506
Portugal,PRT,2019,7,2711,NA,2560,151,5.8984375
Portugal,PRT,2019,8,2546,NA,2464,82,3.3279220779220777
Portugal,PRT,2019,9,2441,NA,2404,37,1.5391014975041597
Portugal,PRT,2019,10,2329,NA,2311,18,0.7788836001730853
Portugal,PRT,2019,11,2258,NA,2267,-9,-0.3970004411116012
Portugal,PRT,2019,12,2199,NA,2194,5,0.22789425706472194
Portugal,PRT,2019,13,2135,NA,2180,-45,-2.064220183486239
Portugal,PRT,2019,14,2097,NA,2187,-90,-4.11522633744856
Portugal,PRT,2019,15,2132,NA,2152,-20,-0.929368029739777
Portugal,PRT,2019,16,2096,NA,2027,69,3.4040453872718306
Portugal,PRT,2019,17,2084,NA,2032,52,2.559055118110236
Portugal,PRT,2019,18,2081,NA,2014,67,3.326713008937438
Portugal,PRT,2019,19,1988,NA,1913,75,3.9205436487192893
Portugal,PRT,2019,20,1931,NA,1969,-38,-1.9299136617572372
Portugal,PRT,2019,21,1919,NA,1948,-29,-1.48870636550308
Portugal,PRT,2019,22,1948,NA,1907,41,2.149973780807551
Portugal,PRT,2019,23,1841,NA,1888,-47,-2.489406779661017
Portugal,PRT,2019,24,1873,NA,1892,-19,-1.004228329809725
Portugal,PRT,2019,25,1916,NA,2019,-103,-5.101535413571074
Portugal,PRT,2019,26,1919,NA,1883,36,1.9118428040361128
Portugal,PRT,2019,27,1882,NA,1839,43,2.3382272974442633
Portugal,PRT,2019,28,1898,NA,1852,46,2.4838012958963285
Portugal,PRT,2019,29,1821,NA,1846,-25,-1.3542795232936078
Portugal,PRT,2019,30,1841,NA,1880,-39,-2.074468085106383
Portugal,PRT,2019,31,1843,NA,1929,-86,-4.458268532918611
Portugal,PRT,2019,32,1838,NA,1967,-129,-6.558210472801221
Portugal,PRT,2019,33,1769,NA,1842,-73,-3.9630836047774154
Portugal,PRT,2019,34,1938,NA,1943,-5,-0.2573340195573855
Portugal,PRT,2019,35,1880,NA,1808,72,3.982300884955752
Portugal,PRT,2019,36,1933,NA,1854,79,4.261057173678533
Portugal,PRT,2019,37,1808,NA,1778,30,1.687289088863892
Portugal,PRT,2019,38,1899,NA,1848,51,2.75974025974026
Portugal,PRT,2019,39,1822,NA,1862,-40,-2.1482277121374866
Portugal,PRT,2019,40,1901,NA,1908,-7,-0.3668763102725367
Portugal,PRT,2019,41,1860,NA,1888,-28,-1.4830508474576272
Portugal,PRT,2019,42,1909,NA,1970,-61,-3.0964467005076144
Portugal,PRT,2019,43,2131,NA,2008,123,6.125498007968128
Portugal,PRT,2019,44,2134,NA,2008,126,6.274900398406374
Portugal,PRT,2019,45,2097,NA,2043,54,2.643171806167401
Portugal,PRT,2019,46,2148,NA,2132,16,0.7504690431519699
Portugal,PRT,2019,47,2233,NA,2167,66,3.0456852791878175
Portugal,PRT,2019,48,2241,NA,2238,3,0.13404825737265416
Portugal,PRT,2019,49,2128,NA,2276,-148,-6.502636203866433
Portugal,PRT,2019,50,2290,NA,2350,-60,-2.553191489361702
Portugal,PRT,2019,51,2284,NA,2463,-179,-7.267559886317498
Portugal,PRT,2019,52,2313,NA,2657,-344,-12.9469326307866
Portugal,PRT,2020,1,2498,NA,2790,-292,-10.46594982078853
Portugal,PRT,2020,2,2654,NA,2746,-92,-3.3503277494537507
Portugal,PRT,2020,3,2762,NA,2782,-20,-0.7189072609633357
Portugal,PRT,2020,4,2662,NA,2760,-98,-3.5507246376811596
Portugal,PRT,2020,5,2678,NA,2631,47,1.7863930064614217
Portugal,PRT,2020,6,2476,NA,2592,-116,-4.4753086419753085
Portugal,PRT,2020,7,2274,NA,2560,-286,-11.171875
Portugal,PRT,2020,8,2356,NA,2464,-108,-4.383116883116883
Portugal,PRT,2020,9,2299,0,2404,-105,-4.367720465890184
Portugal,PRT,2020,10,2174,0,2311,-137,-5.928169623539594
Portugal,PRT,2020,11,2343,0,2267,76,3.3524481693868546
Portugal,PRT,2020,12,2431,23,2194,237,10.80218778486782
Portugal,PRT,2020,13,2536,117,2180,356,16.3302752293578
Portugal,PRT,2020,14,2650,171,2187,463,21.170553269318702
Portugal,PRT,2020,15,2602,224,2152,450,20.910780669144984
Portugal,PRT,2020,16,2380,200,2027,353,17.414898865318204
Portugal,PRT,2020,17,2302,213,2032,270,13.287401574803152
Portugal,PRT,2020,18,2154,115,2014,140,6.951340615690168
Portugal,PRT,2020,19,2155,81,1913,242,12.650287506534239
Portugal,PRT,2020,20,2042,87,1969,73,3.7074657186389035
Portugal,PRT,2020,21,2026,99,1948,78,4.004106776180698
Serbie,SRB,2016,1,2324,NA,2504,-180,-7.188498402555911
Serbie,SRB,2016,2,2086,NA,2484,-398,-16.022544283413847
Serbie,SRB,2016,3,2075,NA,2423,-348,-14.362360709863806
Serbie,SRB,2016,4,2095,NA,2279,-184,-8.073716542343133
Serbie,SRB,2016,5,2096,NA,2314,-218,-9.4209161624891955
Serbie,SRB,2016,6,2038,NA,2195,-157,-7.152619589977221
Serbie,SRB,2016,7,2058,NA,2247,-189,-8.411214953271028
Serbie,SRB,2016,8,1924,NA,2185,-261,-11.94508009153318
Serbie,SRB,2016,9,1999,NA,2197,-198,-9.012289485662267
Serbie,SRB,2016,10,1917,NA,2093,-176,-8.4089823220258
Serbie,SRB,2016,11,1980,NA,2049,-69,-3.3674963396778916
Serbie,SRB,2016,12,1919,NA,1996,-77,-3.857715430861723
Serbie,SRB,2016,13,2017,NA,1969,48,2.437785678009142
Serbie,SRB,2016,14,2049,NA,2023,26,1.2852199703410776
Serbie,SRB,2016,15,1828,NA,1908,-80,-4.1928721174004195
Serbie,SRB,2016,16,1886,NA,1907,-21,-1.101206082852648
Serbie,SRB,2016,17,1865,NA,1888,-23,-1.2182203389830508
Serbie,SRB,2016,18,1833,NA,1858,-25,-1.3455328310010763
Serbie,SRB,2016,19,1900,NA,1835,65,3.5422343324250685
Serbie,SRB,2016,20,1862,NA,1836,26,1.4161220043572984
Serbie,SRB,2016,21,1947,NA,1833,114,6.219312602291326
Serbie,SRB,2016,22,1835,NA,1866,-31,-1.6613076098606645
Serbie,SRB,2016,23,1687,NA,1753,-66,-3.7649743297204794
Serbie,SRB,2016,24,1863,NA,1775,88,4.957746478873239
Serbie,SRB,2016,25,2013,NA,1809,204,11.276948590381426
Serbie,SRB,2016,26,1766,NA,1788,-22,-1.2304250559284116
Serbie,SRB,2016,27,1647,NA,1724,-77,-4.466357308584687
Serbie,SRB,2016,28,1775,NA,1786,-11,-0.6159014557670772
Serbie,SRB,2016,29,1807,NA,1777,30,1.6882386043894204
Serbie,SRB,2016,30,1756,NA,1713,43,2.5102159953298306
Serbie,SRB,2016,31,1667,NA,1772,-105,-5.925507900677201
Serbie,SRB,2016,32,1646,NA,1794,-148,-8.249721293199554
Serbie,SRB,2016,33,1774,NA,1774,0,0
Serbie,SRB,2016,34,1697,NA,1730,-33,-1.907514450867052
Serbie,SRB,2016,35,1770,NA,1731,39,2.2530329289428077
Serbie,SRB,2016,36,1697,NA,1670,27,1.6167664670658684
Serbie,SRB,2016,37,1749,NA,1721,28,1.6269610691458454
Serbie,SRB,2016,38,1724,NA,1740,-16,-0.9195402298850575
Serbie,SRB,2016,39,1887,NA,1839,48,2.6101141924959217
Serbie,SRB,2016,40,1885,NA,1933,-48,-2.4831867563372994
Serbie,SRB,2016,41,2004,NA,1950,54,2.769230769230769
Serbie,SRB,2016,42,2011,NA,1953,58,2.9697900665642605
Serbie,SRB,2016,43,1905,NA,1913,-8,-0.4181913225300575
Serbie,SRB,2016,44,1908,NA,1886,22,1.166489925768823
Serbie,SRB,2016,45,1922,NA,1901,21,1.1046817464492371
Serbie,SRB,2016,46,1983,NA,1946,37,1.9013360739979446
Serbie,SRB,2016,47,2061,NA,1933,128,6.621831350232799
Serbie,SRB,2016,48,1940,NA,1948,-8,-0.41067761806981523
Serbie,SRB,2016,49,1965,NA,1945,20,1.0282776349614395
Serbie,SRB,2016,50,2063,NA,1996,67,3.356713426853707
Serbie,SRB,2016,51,2401,NA,2134,267,12.511715089034677
Serbie,SRB,2016,52,2865,NA,2285,580,25.38293216630197
Serbie,SRB,2017,1,3184,NA,2504,680,27.15654952076677
Serbie,SRB,2017,2,3381,NA,2484,897,36.11111111111111
Serbie,SRB,2017,3,2992,NA,2423,569,23.483285183656623
Serbie,SRB,2017,4,2632,NA,2279,353,15.489249670908292
Serbie,SRB,2017,5,2527,NA,2314,213,9.204840103716508
Serbie,SRB,2017,6,2143,NA,2195,-52,-2.369020501138952
Serbie,SRB,2017,7,2180,NA,2247,-67,-2.9817534490431687
Serbie,SRB,2017,8,2214,NA,2185,29,1.3272311212814645
Serbie,SRB,2017,9,2108,NA,2197,-89,-4.050978607191625
Serbie,SRB,2017,10,2021,NA,2093,-72,-3.440038222646918
Serbie,SRB,2017,11,1988,NA,2049,-61,-2.977061981454368
Serbie,SRB,2017,12,1967,NA,1996,-29,-1.4529058116232465
Serbie,SRB,2017,13,1826,NA,1969,-143,-7.262569832402235
Serbie,SRB,2017,14,1955,NA,2023,-68,-3.361344537815126
Serbie,SRB,2017,15,1944,NA,1908,36,1.8867924528301887
Serbie,SRB,2017,16,2059,NA,1907,152,7.970634504457262
Serbie,SRB,2017,17,1985,NA,1888,97,5.13771186440678
Serbie,SRB,2017,18,1926,NA,1858,68,3.659849300322928
Serbie,SRB,2017,19,1889,NA,1835,54,2.9427792915531334
Serbie,SRB,2017,20,1885,NA,1836,49,2.6688453159041394
Serbie,SRB,2017,21,1801,NA,1833,-32,-1.745771958537916
Serbie,SRB,2017,22,1965,NA,1866,99,5.305466237942122
Serbie,SRB,2017,23,1776,NA,1753,23,1.3120365088419852
Serbie,SRB,2017,24,1740,NA,1775,-35,-1.971830985915493
Serbie,SRB,2017,25,1785,NA,1809,-24,-1.3266998341625207
Serbie,SRB,2017,26,1888,NA,1788,100,5.592841163310962
Serbie,SRB,2017,27,1658,NA,1724,-66,-3.82830626450116
Serbie,SRB,2017,28,1822,NA,1786,36,2.015677491601344
Serbie,SRB,2017,29,1763,NA,1777,-14,-0.7878446820483961
Serbie,SRB,2017,30,1678,NA,1713,-35,-2.0431990659661414
Serbie,SRB,2017,31,1879,NA,1772,107,6.038374717832957
Serbie,SRB,2017,32,1914,NA,1794,120,6.688963210702341
Serbie,SRB,2017,33,1729,NA,1774,-45,-2.5366403607666292
Serbie,SRB,2017,34,1684,NA,1730,-46,-2.6589595375722546
Serbie,SRB,2017,35,1766,NA,1731,35,2.021952628538417
Serbie,SRB,2017,36,1598,NA,1670,-72,-4.311377245508982
Serbie,SRB,2017,37,1689,NA,1721,-32,-1.8593840790238232
Serbie,SRB,2017,38,1677,NA,1740,-63,-3.620689655172414
Serbie,SRB,2017,39,1773,NA,1839,-66,-3.588907014681892
Serbie,SRB,2017,40,1885,NA,1933,-48,-2.4831867563372994
Serbie,SRB,2017,41,1898,NA,1950,-52,-2.666666666666667
Serbie,SRB,2017,42,1962,NA,1953,9,0.4608294930875576
Serbie,SRB,2017,43,1890,NA,1913,-23,-1.2023000522739153
Serbie,SRB,2017,44,1831,NA,1886,-55,-2.916224814422057
Serbie,SRB,2017,45,1914,NA,1901,13,0.6838506049447659
Serbie,SRB,2017,46,1928,NA,1946,-18,-0.9249743062692704
Serbie,SRB,2017,47,1783,NA,1933,-150,-7.75995861355406
Serbie,SRB,2017,48,1894,NA,1948,-54,-2.772073921971253
Serbie,SRB,2017,49,1950,NA,1945,5,0.2570694087403599
Serbie,SRB,2017,50,1942,NA,1996,-54,-2.7054108216432864
Serbie,SRB,2017,51,1964,NA,2134,-170,-7.966260543580131
Serbie,SRB,2017,52,1908,NA,2285,-377,-16.49890590809628
Serbie,SRB,2018,1,2005,NA,2504,-499,-19.92811501597444
Serbie,SRB,2018,2,1984,NA,2484,-500,-20.128824476650564
Serbie,SRB,2018,3,2201,NA,2423,-222,-9.162195625257946
Serbie,SRB,2018,4,2110,NA,2279,-169,-7.41553312856516
Serbie,SRB,2018,5,2320,NA,2314,6,0.25929127052722556
Serbie,SRB,2018,6,2404,NA,2195,209,9.521640091116174
Serbie,SRB,2018,7,2502,NA,2247,255,11.348464619492656
Serbie,SRB,2018,8,2416,NA,2185,231,10.5720823798627
Serbie,SRB,2018,9,2483,NA,2197,286,13.017751479289942
Serbie,SRB,2018,10,2342,NA,2093,249,11.896798853320592
Serbie,SRB,2018,11,2180,NA,2049,131,6.3933626159102
Serbie,SRB,2018,12,2103,NA,1996,107,5.3607214428857715
Serbie,SRB,2018,13,2064,NA,1969,95,4.824784154393093
Serbie,SRB,2018,14,2064,NA,2023,41,2.026693030153238
Serbie,SRB,2018,15,1951,NA,1908,43,2.2536687631027252
Serbie,SRB,2018,16,1775,NA,1907,-132,-6.92186680650236
Serbie,SRB,2018,17,1814,NA,1888,-74,-3.919491525423729
Serbie,SRB,2018,18,1814,NA,1858,-44,-2.3681377825618943
Serbie,SRB,2018,19,1717,NA,1835,-118,-6.430517711171663
Serbie,SRB,2018,20,1761,NA,1836,-75,-4.084967320261438
Serbie,SRB,2018,21,1752,NA,1833,-81,-4.4189852700491
Serbie,SRB,2018,22,1797,NA,1866,-69,-3.697749196141479
Serbie,SRB,2018,23,1795,NA,1753,42,2.3958927552766687
Serbie,SRB,2018,24,1721,NA,1775,-54,-3.0422535211267605
Serbie,SRB,2018,25,1629,NA,1809,-180,-9.950248756218906
Serbie,SRB,2018,26,1711,NA,1788,-77,-4.306487695749441
Serbie,SRB,2018,27,1867,NA,1724,143,8.294663573085845
Serbie,SRB,2018,28,1760,NA,1786,-26,-1.4557670772676372
Serbie,SRB,2018,29,1762,NA,1777,-15,-0.8441193021947102
Serbie,SRB,2018,30,1705,NA,1713,-8,-0.46701692936368944
Serbie,SRB,2018,31,1771,NA,1772,-1,-0.0564334085778781
Serbie,SRB,2018,32,1822,NA,1794,28,1.560758082497213
Serbie,SRB,2018,33,1819,NA,1774,45,2.5366403607666292
Serbie,SRB,2018,34,1808,NA,1730,78,4.508670520231214
Serbie,SRB,2018,35,1657,NA,1731,-74,-4.274985557481225
Serbie,SRB,2018,36,1716,NA,1670,46,2.754491017964072
Serbie,SRB,2018,37,1725,NA,1721,4,0.2324230098779779
Serbie,SRB,2018,38,1819,NA,1740,79,4.540229885057472
Serbie,SRB,2018,39,1856,NA,1839,17,0.9244154431756388
Serbie,SRB,2018,40,2029,NA,1933,96,4.966373512674599
Serbie,SRB,2018,41,1947,NA,1950,-3,-0.15384615384615385
Serbie,SRB,2018,42,1887,NA,1953,-66,-3.3794162826420893
Serbie,SRB,2018,43,1945,NA,1913,32,1.67276529012023
Serbie,SRB,2018,44,1918,NA,1886,32,1.6967126193001063
Serbie,SRB,2018,45,1867,NA,1901,-34,-1.788532351394003
Serbie,SRB,2018,46,1926,NA,1946,-20,-1.027749229188078
Serbie,SRB,2018,47,1955,NA,1933,22,1.1381272633212622
Serbie,SRB,2018,48,2010,NA,1948,62,3.1827515400410675
Serbie,SRB,2018,49,1921,NA,1945,-24,-1.2339331619537275
Serbie,SRB,2018,50,1984,NA,1996,-12,-0.6012024048096193
Serbie,SRB,2018,51,2038,NA,2134,-96,-4.498594189315839
Serbie,SRB,2018,52,2082,NA,2285,-203,-8.884026258205688
Slovaquie,SVK,2016,1,1072,NA,1170,-98,-8.376068376068375
Slovaquie,SVK,2016,2,948,NA,1150,-202,-17.565217391304348
Slovaquie,SVK,2016,3,1026,NA,1198,-172,-14.357262103505844
Slovaquie,SVK,2016,4,982,NA,1142,-160,-14.010507880910684
Slovaquie,SVK,2016,5,1045,NA,1203,-158,-13.13383208645054
Slovaquie,SVK,2016,6,1041,NA,1185,-144,-12.151898734177214
Slovaquie,SVK,2016,7,1051,NA,1167,-116,-9.940017137960583
Slovaquie,SVK,2016,8,1023,NA,1171,-148,-12.63877028181042
Slovaquie,SVK,2016,9,1003,NA,1181,-178,-15.071972904318374
Slovaquie,SVK,2016,10,1009,NA,1142,-133,-11.646234676007005
Slovaquie,SVK,2016,11,1032,NA,1081,-49,-4.532839962997224
Slovaquie,SVK,2016,12,1026,NA,1074,-48,-4.4692737430167595
Slovaquie,SVK,2016,13,999,NA,1042,-43,-4.126679462571977
Slovaquie,SVK,2016,14,1017,NA,1011,6,0.5934718100890208
Slovaquie,SVK,2016,15,971,NA,1034,-63,-6.09284332688588
Slovaquie,SVK,2016,16,1010,NA,986,24,2.434077079107505
Slovaquie,SVK,2016,17,988,NA,996,-8,-0.8032128514056224
Slovaquie,SVK,2016,18,1019,NA,979,40,4.085801838610827
Slovaquie,SVK,2016,19,988,NA,954,34,3.563941299790356
Slovaquie,SVK,2016,20,934,NA,952,-18,-1.8907563025210083
Slovaquie,SVK,2016,21,1004,NA,957,47,4.911180773249739
Slovaquie,SVK,2016,22,984,NA,960,24,2.5
Slovaquie,SVK,2016,23,885,NA,898,-13,-1.447661469933185
Slovaquie,SVK,2016,24,898,NA,964,-66,-6.846473029045644
Slovaquie,SVK,2016,25,1056,NA,966,90,9.316770186335404
Slovaquie,SVK,2016,26,899,NA,930,-31,-3.3333333333333335
Slovaquie,SVK,2016,27,909,NA,920,-11,-1.1956521739130435
Slovaquie,SVK,2016,28,958,NA,926,32,3.455723542116631
Slovaquie,SVK,2016,29,937,NA,956,-19,-1.9874476987447698
Slovaquie,SVK,2016,30,933,NA,996,-63,-6.325301204819277
Slovaquie,SVK,2016,31,904,NA,1005,-101,-10.049751243781095
Slovaquie,SVK,2016,32,874,NA,949,-75,-7.903055848261328
Slovaquie,SVK,2016,33,937,NA,921,16,1.737242128121607
Slovaquie,SVK,2016,34,909,NA,938,-29,-3.091684434968017
Slovaquie,SVK,2016,35,934,NA,959,-25,-2.6068821689259645
Slovaquie,SVK,2016,36,954,NA,950,4,0.42105263157894735
Slovaquie,SVK,2016,37,1000,NA,960,40,4.166666666666666
Slovaquie,SVK,2016,38,948,NA,972,-24,-2.4691358024691357
Slovaquie,SVK,2016,39,1003,NA,1002,1,0.09980039920159679
Slovaquie,SVK,2016,40,1029,NA,1011,18,1.7804154302670623
Slovaquie,SVK,2016,41,992,NA,998,-6,-0.6012024048096193
Slovaquie,SVK,2016,42,1071,NA,1019,52,5.103042198233562
Slovaquie,SVK,2016,43,1064,NA,992,72,7.258064516129033
Slovaquie,SVK,2016,44,1028,NA,992,36,3.6290322580645165
Slovaquie,SVK,2016,45,1017,NA,1006,11,1.0934393638170974
Slovaquie,SVK,2016,46,1063,NA,1014,49,4.832347140039447
Slovaquie,SVK,2016,47,1082,NA,1022,60,5.870841487279844
Slovaquie,SVK,2016,48,1067,NA,1028,39,3.7937743190661477
Slovaquie,SVK,2016,49,984,NA,983,1,0.10172939979654119
Slovaquie,SVK,2016,50,1067,NA,1026,41,3.996101364522417
Slovaquie,SVK,2016,51,1200,NA,1108,92,8.303249097472925
Slovaquie,SVK,2016,52,1311,NA,1111,200,18.001800180018
Slovaquie,SVK,2017,1,1411,NA,1170,241,20.598290598290596
Slovaquie,SVK,2017,2,1410,NA,1150,260,22.608695652173914
Slovaquie,SVK,2017,3,1390,NA,1198,192,16.026711185308848
Slovaquie,SVK,2017,4,1355,NA,1142,213,18.65148861646235
Slovaquie,SVK,2017,5,1339,NA,1203,136,11.305070656691605
Slovaquie,SVK,2017,6,1202,NA,1185,17,1.4345991561181435
Slovaquie,SVK,2017,7,1224,NA,1167,57,4.884318766066838
Slovaquie,SVK,2017,8,1115,NA,1171,-56,-4.782237403928266
Slovaquie,SVK,2017,9,1159,NA,1181,-22,-1.8628281117696865
Slovaquie,SVK,2017,10,1002,NA,1142,-140,-12.259194395796849
Slovaquie,SVK,2017,11,1016,NA,1081,-65,-6.01295097132285
Slovaquie,SVK,2017,12,1092,NA,1074,18,1.675977653631285
Slovaquie,SVK,2017,13,1017,NA,1042,-25,-2.399232245681382
Slovaquie,SVK,2017,14,989,NA,1011,-22,-2.1760633036597428
Slovaquie,SVK,2017,15,1024,NA,1034,-10,-0.9671179883945842
Slovaquie,SVK,2017,16,1008,NA,986,22,2.231237322515213
Slovaquie,SVK,2017,17,1023,NA,996,27,2.710843373493976
Slovaquie,SVK,2017,18,955,NA,979,-24,-2.4514811031664965
Slovaquie,SVK,2017,19,919,NA,954,-35,-3.668763102725367
Slovaquie,SVK,2017,20,925,NA,952,-27,-2.8361344537815127
Slovaquie,SVK,2017,21,916,NA,957,-41,-4.284221525600835
Slovaquie,SVK,2017,22,949,NA,960,-11,-1.1458333333333333
Slovaquie,SVK,2017,23,858,NA,898,-40,-4.4543429844097995
Slovaquie,SVK,2017,24,918,NA,964,-46,-4.771784232365145
Slovaquie,SVK,2017,25,923,NA,966,-43,-4.451345755693581
Slovaquie,SVK,2017,26,977,NA,930,47,5.053763440860215
Slovaquie,SVK,2017,27,915,NA,920,-5,-0.5434782608695652
Slovaquie,SVK,2017,28,900,NA,926,-26,-2.8077753779697625
Slovaquie,SVK,2017,29,969,NA,956,13,1.3598326359832638
Slovaquie,SVK,2017,30,948,NA,996,-48,-4.819277108433735
Slovaquie,SVK,2017,31,1064,NA,1005,59,5.870646766169154
Slovaquie,SVK,2017,32,990,NA,949,41,4.3203371970495255
Slovaquie,SVK,2017,33,958,NA,921,37,4.017372421281216
Slovaquie,SVK,2017,34,918,NA,938,-20,-2.1321961620469083
Slovaquie,SVK,2017,35,931,NA,959,-28,-2.9197080291970803
Slovaquie,SVK,2017,36,953,NA,950,3,0.3157894736842105
Slovaquie,SVK,2017,37,951,NA,960,-9,-0.9375
Slovaquie,SVK,2017,38,977,NA,972,5,0.51440329218107
Slovaquie,SVK,2017,39,1023,NA,1002,21,2.095808383233533
Slovaquie,SVK,2017,40,1039,NA,1011,28,2.7695351137487636
Slovaquie,SVK,2017,41,1036,NA,998,38,3.807615230460922
Slovaquie,SVK,2017,42,1004,NA,1019,-15,-1.4720314033366046
Slovaquie,SVK,2017,43,919,NA,992,-73,-7.358870967741936
Slovaquie,SVK,2017,44,984,NA,992,-8,-0.8064516129032258
Slovaquie,SVK,2017,45,990,NA,1006,-16,-1.5904572564612325
Slovaquie,SVK,2017,46,998,NA,1014,-16,-1.5779092702169626
Slovaquie,SVK,2017,47,997,NA,1022,-25,-2.446183953033268
Slovaquie,SVK,2017,48,1015,NA,1028,-13,-1.264591439688716
Slovaquie,SVK,2017,49,971,NA,983,-12,-1.2207527975584944
Slovaquie,SVK,2017,50,1003,NA,1026,-23,-2.241715399610136
Slovaquie,SVK,2017,51,1051,NA,1108,-57,-5.144404332129964
Slovaquie,SVK,2017,52,1082,NA,1111,-29,-2.6102610261026102
Slovaquie,SVK,2018,1,1094,NA,1170,-76,-6.495726495726497
Slovaquie,SVK,2018,2,1150,NA,1150,0,0
Slovaquie,SVK,2018,3,1198,NA,1198,0,0
Slovaquie,SVK,2018,4,1095,NA,1142,-47,-4.115586690017513
Slovaquie,SVK,2018,5,1205,NA,1203,2,0.1662510390689942
Slovaquie,SVK,2018,6,1159,NA,1185,-26,-2.1940928270042197
Slovaquie,SVK,2018,7,1140,NA,1167,-27,-2.313624678663239
Slovaquie,SVK,2018,8,1292,NA,1171,121,10.333048676345005
Slovaquie,SVK,2018,9,1353,NA,1181,172,14.563928873835733
Slovaquie,SVK,2018,10,1357,NA,1142,215,18.82661996497373
Slovaquie,SVK,2018,11,1165,NA,1081,84,7.770582793709528
Slovaquie,SVK,2018,12,1111,NA,1074,37,3.445065176908752
Slovaquie,SVK,2018,13,1128,NA,1042,86,8.253358925143955
Slovaquie,SVK,2018,14,1051,NA,1011,40,3.956478733926805
Slovaquie,SVK,2018,15,1070,NA,1034,36,3.481624758220503
Slovaquie,SVK,2018,16,944,NA,986,-42,-4.259634888438134
Slovaquie,SVK,2018,17,906,NA,996,-90,-9.036144578313253
Slovaquie,SVK,2018,18,963,NA,979,-16,-1.634320735444331
Slovaquie,SVK,2018,19,952,NA,954,-2,-0.20964360587002098
Slovaquie,SVK,2018,20,1004,NA,952,52,5.46218487394958
Slovaquie,SVK,2018,21,986,NA,957,29,3.0303030303030303
Slovaquie,SVK,2018,22,985,NA,960,25,2.604166666666667
Slovaquie,SVK,2018,23,922,NA,898,24,2.6726057906458798
Slovaquie,SVK,2018,24,955,NA,964,-9,-0.9336099585062241
Slovaquie,SVK,2018,25,891,NA,966,-75,-7.763975155279502
Slovaquie,SVK,2018,26,922,NA,930,-8,-0.8602150537634409
Slovaquie,SVK,2018,27,946,NA,920,26,2.8260869565217392
Slovaquie,SVK,2018,28,970,NA,926,44,4.751619870410368
Slovaquie,SVK,2018,29,969,NA,956,13,1.3598326359832638
Slovaquie,SVK,2018,30,1080,NA,996,84,8.433734939759036
Slovaquie,SVK,2018,31,1110,NA,1005,105,10.44776119402985
Slovaquie,SVK,2018,32,991,NA,949,42,4.425711275026344
Slovaquie,SVK,2018,33,931,NA,921,10,1.0857763300760044
Slovaquie,SVK,2018,34,961,NA,938,23,2.4520255863539444
Slovaquie,SVK,2018,35,940,NA,959,-19,-1.981230448383733
Slovaquie,SVK,2018,36,999,NA,950,49,5.157894736842105
Slovaquie,SVK,2018,37,952,NA,960,-8,-0.8333333333333334
Slovaquie,SVK,2018,38,1019,NA,972,47,4.8353909465020575
Slovaquie,SVK,2018,39,1007,NA,1002,5,0.499001996007984
Slovaquie,SVK,2018,40,995,NA,1011,-16,-1.582591493570722
Slovaquie,SVK,2018,41,1022,NA,998,24,2.404809619238477
Slovaquie,SVK,2018,42,982,NA,1019,-37,-3.631010794896958
Slovaquie,SVK,2018,43,1043,NA,992,51,5.141129032258065
Slovaquie,SVK,2018,44,955,NA,992,-37,-3.7298387096774195
Slovaquie,SVK,2018,45,1030,NA,1006,24,2.3856858846918487
Slovaquie,SVK,2018,46,994,NA,1014,-20,-1.9723865877712032
Slovaquie,SVK,2018,47,1021,NA,1022,-1,-0.09784735812133072
Slovaquie,SVK,2018,48,1036,NA,1028,8,0.7782101167315175
Slovaquie,SVK,2018,49,1009,NA,983,26,2.644964394710071
Slovaquie,SVK,2018,50,1034,NA,1026,8,0.7797270955165692
Slovaquie,SVK,2018,51,1129,NA,1108,21,1.895306859205776
Slovaquie,SVK,2018,52,1014,NA,1111,-97,-8.730873087308732
Slovaquie,SVK,2019,1,1105,NA,1170,-65,-5.555555555555555
Slovaquie,SVK,2019,2,1094,NA,1150,-56,-4.869565217391305
Slovaquie,SVK,2019,3,1176,NA,1198,-22,-1.8363939899833055
Slovaquie,SVK,2019,4,1135,NA,1142,-7,-0.6129597197898424
Slovaquie,SVK,2019,5,1224,NA,1203,21,1.7456359102244388
Slovaquie,SVK,2019,6,1339,NA,1185,154,12.995780590717299
Slovaquie,SVK,2019,7,1252,NA,1167,85,7.28363324764353
Slovaquie,SVK,2019,8,1254,NA,1171,83,7.087959009393681
Slovaquie,SVK,2019,9,1208,NA,1181,27,2.2861981371718882
Slovaquie,SVK,2019,10,1200,NA,1142,58,5.078809106830122
Slovaquie,SVK,2019,11,1110,NA,1081,29,2.682701202590194
Slovaquie,SVK,2019,12,1068,NA,1074,-6,-0.5586592178770949
Slovaquie,SVK,2019,13,1025,NA,1042,-17,-1.6314779270633395
Slovaquie,SVK,2019,14,986,NA,1011,-25,-2.472799208704253
Slovaquie,SVK,2019,15,1073,NA,1034,39,3.771760154738878
Slovaquie,SVK,2019,16,984,NA,986,-2,-0.2028397565922921
Slovaquie,SVK,2019,17,1065,NA,996,69,6.927710843373494
Slovaquie,SVK,2019,18,979,NA,979,0,0
Slovaquie,SVK,2019,19,955,NA,954,1,0.10482180293501049
Slovaquie,SVK,2019,20,943,NA,952,-9,-0.9453781512605042
Slovaquie,SVK,2019,21,922,NA,957,-35,-3.657262277951933
Slovaquie,SVK,2019,22,924,NA,960,-36,-3.75
Slovaquie,SVK,2019,23,929,NA,898,31,3.4521158129175946
Slovaquie,SVK,2019,24,1086,NA,964,122,12.655601659751037
Slovaquie,SVK,2019,25,996,NA,966,30,3.1055900621118013
Slovaquie,SVK,2019,26,924,NA,930,-6,-0.6451612903225806
Slovaquie,SVK,2019,27,910,NA,920,-10,-1.0869565217391304
Slovaquie,SVK,2019,28,876,NA,926,-50,-5.399568034557236
Slovaquie,SVK,2019,29,947,NA,956,-9,-0.9414225941422595
Slovaquie,SVK,2019,30,1025,NA,996,29,2.9116465863453818
Slovaquie,SVK,2019,31,941,NA,1005,-64,-6.368159203980099
Slovaquie,SVK,2019,32,941,NA,949,-8,-0.8429926238145415
Slovaquie,SVK,2019,33,858,NA,921,-63,-6.840390879478828
Slovaquie,SVK,2019,34,963,NA,938,25,2.6652452025586353
Slovaquie,SVK,2019,35,1032,NA,959,73,7.6120959332638165
Slovaquie,SVK,2019,36,894,NA,950,-56,-5.894736842105263
Slovaquie,SVK,2019,37,936,NA,960,-24,-2.5
Slovaquie,SVK,2019,38,943,NA,972,-29,-2.983539094650206
Slovaquie,SVK,2019,39,976,NA,1002,-26,-2.5948103792415167
Slovaquie,SVK,2019,40,980,NA,1011,-31,-3.066271018793274
Slovaquie,SVK,2019,41,943,NA,998,-55,-5.511022044088176
Slovaquie,SVK,2019,42,1020,NA,1019,1,0.09813542688910697
Slovaquie,SVK,2019,43,941,NA,992,-51,-5.141129032258065
Slovaquie,SVK,2019,44,1001,NA,992,9,0.9072580645161291
Slovaquie,SVK,2019,45,989,NA,1006,-17,-1.6898608349900597
Slovaquie,SVK,2019,46,1003,NA,1014,-11,-1.0848126232741617
Slovaquie,SVK,2019,47,986,NA,1022,-36,-3.522504892367906
Slovaquie,SVK,2019,48,994,NA,1028,-34,-3.3073929961089497
Slovaquie,SVK,2019,49,969,NA,983,-14,-1.4242115971515767
Slovaquie,SVK,2019,50,1002,NA,1026,-24,-2.3391812865497075
Slovaquie,SVK,2019,51,1053,NA,1108,-55,-4.9638989169675085
Slovaquie,SVK,2019,52,1036,NA,1111,-75,-6.750675067506751
Slovaquie,SVK,2020,1,1056,NA,1170,-114,-9.7435897435897445
Slovaquie,SVK,2020,2,1097,NA,1150,-53,-4.608695652173913
Slovaquie,SVK,2020,3,1079,NA,1198,-119,-9.93322203672788
Slovaquie,SVK,2020,4,1097,NA,1142,-45,-3.940455341506129
Slovaquie,SVK,2020,5,1149,NA,1203,-54,-4.488778054862843
Slovaquie,SVK,2020,6,1091,NA,1185,-94,-7.932489451476793
Slovaquie,SVK,2020,7,1169,NA,1167,2,0.17137960582690662
Slovaquie,SVK,2020,8,1078,NA,1171,-93,-7.941929974380871
Slovaquie,SVK,2020,9,1136,NA,1181,-45,-3.810330228619814
Slovaquie,SVK,2020,10,1108,0,1142,-34,-2.9772329246935203
Slovaquie,SVK,2020,11,1093,0,1081,12,1.1100832562442182
Slovaquie,SVK,2020,12,1163,0,1074,89,8.286778398510242
Slovaquie,SVK,2020,13,1040,0,1042,-2,-0.19193857965451055
Slovaquie,SVK,2020,14,1023,2,1011,12,1.1869436201780417
Slovaquie,SVK,2020,15,935,0,1034,-99,-9.574468085106384
Slovaquie,SVK,2020,16,915,11,986,-71,-7.200811359026369
Slovaquie,SVK,2020,17,920,5,996,-76,-7.630522088353414
Slovaquie,SVK,2020,18,485,7,979,-494,-50.45965270684371
Slovénie,SVN,2016,1,451,NA,444,7,1.5765765765765765
Slovénie,SVN,2016,2,439,NA,462,-23,-4.978354978354979
Slovénie,SVN,2016,3,411,NA,465,-54,-11.612903225806452
Slovénie,SVN,2016,4,457,NA,484,-27,-5.578512396694215
Slovénie,SVN,2016,5,434,NA,497,-63,-12.676056338028168
Slovénie,SVN,2016,6,426,NA,456,-30,-6.578947368421052
Slovénie,SVN,2016,7,421,NA,459,-38,-8.278867102396514
Slovénie,SVN,2016,8,406,NA,447,-41,-9.172259507829978
Slovénie,SVN,2016,9,427,NA,459,-32,-6.971677559912854
Slovénie,SVN,2016,10,416,NA,417,-1,-0.2398081534772182
Slovénie,SVN,2016,11,411,NA,429,-18,-4.195804195804196
Slovénie,SVN,2016,12,388,NA,416,-28,-6.730769230769231
Slovénie,SVN,2016,13,441,NA,428,13,3.0373831775700935
Slovénie,SVN,2016,14,373,NA,384,-11,-2.864583333333333
Slovénie,SVN,2016,15,339,NA,359,-20,-5.571030640668524
Slovénie,SVN,2016,16,399,NA,391,8,2.0460358056265986
Slovénie,SVN,2016,17,351,NA,374,-23,-6.149732620320856
Slovénie,SVN,2016,18,367,NA,356,11,3.089887640449438
Slovénie,SVN,2016,19,358,NA,361,-3,-0.8310249307479225
Slovénie,SVN,2016,20,346,NA,351,-5,-1.4245014245014245
Slovénie,SVN,2016,21,355,NA,352,3,0.8522727272727272
Slovénie,SVN,2016,22,334,NA,357,-23,-6.442577030812324
Slovénie,SVN,2016,23,347,NA,352,-5,-1.4204545454545454
Slovénie,SVN,2016,24,348,NA,343,5,1.4577259475218658
Slovénie,SVN,2016,25,335,NA,346,-11,-3.1791907514450863
Slovénie,SVN,2016,26,334,NA,328,6,1.8292682926829267
Slovénie,SVN,2016,27,347,NA,346,1,0.2890173410404624
Slovénie,SVN,2016,28,370,NA,339,31,9.144542772861357
Slovénie,SVN,2016,29,312,NA,347,-35,-10.086455331412104
Slovénie,SVN,2016,30,342,NA,345,-3,-0.8695652173913043
Slovénie,SVN,2016,31,319,NA,355,-36,-10.140845070422536
Slovénie,SVN,2016,32,326,NA,345,-19,-5.507246376811594
Slovénie,SVN,2016,33,355,NA,349,6,1.7191977077363898
Slovénie,SVN,2016,34,343,NA,358,-15,-4.189944134078212
Slovénie,SVN,2016,35,373,NA,373,0,0
Slovénie,SVN,2016,36,332,NA,343,-11,-3.206997084548105
Slovénie,SVN,2016,37,363,NA,365,-2,-0.547945205479452
Slovénie,SVN,2016,38,358,NA,368,-10,-2.717391304347826
Slovénie,SVN,2016,39,355,NA,357,-2,-0.5602240896358543
Slovénie,SVN,2016,40,369,NA,386,-17,-4.404145077720207
Slovénie,SVN,2016,41,390,NA,377,13,3.4482758620689653
Slovénie,SVN,2016,42,375,NA,374,1,0.267379679144385
Slovénie,SVN,2016,43,395,NA,387,8,2.0671834625323
Slovénie,SVN,2016,44,341,NA,373,-32,-8.579088471849866
Slovénie,SVN,2016,45,374,NA,367,7,1.9073569482288828
Slovénie,SVN,2016,46,381,NA,389,-8,-2.056555269922879
Slovénie,SVN,2016,47,366,NA,380,-14,-3.684210526315789
Slovénie,SVN,2016,48,357,NA,375,-18,-4.8
Slovénie,SVN,2016,49,394,NA,400,-6,-1.5
Slovénie,SVN,2016,50,347,NA,386,-39,-10.103626943005182
Slovénie,SVN,2016,51,413,NA,412,1,0.24271844660194172
Slovénie,SVN,2016,52,466,NA,436,30,6.8807339449541285
Slovénie,SVN,2017,1,479,NA,444,35,7.882882882882883
Slovénie,SVN,2017,2,536,NA,462,74,16.017316017316016
Slovénie,SVN,2017,3,586,NA,465,121,26.021505376344084
Slovénie,SVN,2017,4,569,NA,484,85,17.56198347107438
Slovénie,SVN,2017,5,599,NA,497,102,20.52313883299799
Slovénie,SVN,2017,6,523,NA,456,67,14.692982456140353
Slovénie,SVN,2017,7,466,NA,459,7,1.5250544662309369
Slovénie,SVN,2017,8,459,NA,447,12,2.684563758389262
Slovénie,SVN,2017,9,439,NA,459,-20,-4.357298474945534
Slovénie,SVN,2017,10,369,NA,417,-48,-11.510791366906476
Slovénie,SVN,2017,11,397,NA,429,-32,-7.459207459207459
Slovénie,SVN,2017,12,418,NA,416,2,0.4807692307692308
Slovénie,SVN,2017,13,413,NA,428,-15,-3.5046728971962615
Slovénie,SVN,2017,14,357,NA,384,-27,-7.03125
Slovénie,SVN,2017,15,348,NA,359,-11,-3.064066852367688
Slovénie,SVN,2017,16,385,NA,391,-6,-1.5345268542199488
Slovénie,SVN,2017,17,371,NA,374,-3,-0.8021390374331552
Slovénie,SVN,2017,18,355,NA,356,-1,-0.2808988764044944
Slovénie,SVN,2017,19,358,NA,361,-3,-0.8310249307479225
Slovénie,SVN,2017,20,360,NA,351,9,2.564102564102564
Slovénie,SVN,2017,21,347,NA,352,-5,-1.4204545454545454
Slovénie,SVN,2017,22,371,NA,357,14,3.9215686274509802
Slovénie,SVN,2017,23,348,NA,352,-4,-1.1363636363636365
Slovénie,SVN,2017,24,342,NA,343,-1,-0.2915451895043732
Slovénie,SVN,2017,25,348,NA,346,2,0.5780346820809248
Slovénie,SVN,2017,26,334,NA,328,6,1.8292682926829267
Slovénie,SVN,2017,27,369,NA,346,23,6.6473988439306355
Slovénie,SVN,2017,28,328,NA,339,-11,-3.2448377581120944
Slovénie,SVN,2017,29,354,NA,347,7,2.0172910662824206
Slovénie,SVN,2017,30,328,NA,345,-17,-4.9275362318840585
Slovénie,SVN,2017,31,347,NA,355,-8,-2.2535211267605635
Slovénie,SVN,2017,32,319,NA,345,-26,-7.536231884057972
Slovénie,SVN,2017,33,354,NA,349,5,1.4326647564469914
Slovénie,SVN,2017,34,350,NA,358,-8,-2.2346368715083798
Slovénie,SVN,2017,35,380,NA,373,7,1.876675603217158
Slovénie,SVN,2017,36,339,NA,343,-4,-1.1661807580174928
Slovénie,SVN,2017,37,340,NA,365,-25,-6.8493150684931505
Slovénie,SVN,2017,38,364,NA,368,-4,-1.0869565217391304
Slovénie,SVN,2017,39,374,NA,357,17,4.761904761904762
Slovénie,SVN,2017,40,398,NA,386,12,3.1088082901554404
Slovénie,SVN,2017,41,370,NA,377,-7,-1.8567639257294428
Slovénie,SVN,2017,42,376,NA,374,2,0.53475935828877
Slovénie,SVN,2017,43,350,NA,387,-37,-9.560723514211885
Slovénie,SVN,2017,44,385,NA,373,12,3.2171581769436997
Slovénie,SVN,2017,45,380,NA,367,13,3.5422343324250685
Slovénie,SVN,2017,46,393,NA,389,4,1.0282776349614395
Slovénie,SVN,2017,47,391,NA,380,11,2.8947368421052633
Slovénie,SVN,2017,48,362,NA,375,-13,-3.4666666666666663
Slovénie,SVN,2017,49,399,NA,400,-1,-0.25
Slovénie,SVN,2017,50,390,NA,386,4,1.0362694300518136
Slovénie,SVN,2017,51,397,NA,412,-15,-3.640776699029126
Slovénie,SVN,2017,52,422,NA,436,-14,-3.211009174311927
Slovénie,SVN,2018,1,401,NA,444,-43,-9.684684684684685
Slovénie,SVN,2018,2,411,NA,462,-51,-11.03896103896104
Slovénie,SVN,2018,3,398,NA,465,-67,-14.408602150537634
Slovénie,SVN,2018,4,425,NA,484,-59,-12.190082644628099
Slovénie,SVN,2018,5,457,NA,497,-40,-8.048289738430583
Slovénie,SVN,2018,6,419,NA,456,-37,-8.114035087719298
Slovénie,SVN,2018,7,490,NA,459,31,6.753812636165578
Slovénie,SVN,2018,8,476,NA,447,29,6.487695749440715
Slovénie,SVN,2018,9,512,NA,459,53,11.546840958605664
Slovénie,SVN,2018,10,465,NA,417,48,11.510791366906476
Slovénie,SVN,2018,11,479,NA,429,50,11.655011655011654
Slovénie,SVN,2018,12,443,NA,416,27,6.490384615384616
Slovénie,SVN,2018,13,431,NA,428,3,0.7009345794392523
Slovénie,SVN,2018,14,421,NA,384,37,9.635416666666668
Slovénie,SVN,2018,15,390,NA,359,31,8.635097493036211
Slovénie,SVN,2018,16,390,NA,391,-1,-0.2557544757033248
Slovénie,SVN,2018,17,400,NA,374,26,6.951871657754011
Slovénie,SVN,2018,18,345,NA,356,-11,-3.089887640449438
Slovénie,SVN,2018,19,367,NA,361,6,1.662049861495845
Slovénie,SVN,2018,20,348,NA,351,-3,-0.8547008547008548
Slovénie,SVN,2018,21,353,NA,352,1,0.2840909090909091
Slovénie,SVN,2018,22,366,NA,357,9,2.5210084033613445
Slovénie,SVN,2018,23,360,NA,352,8,2.272727272727273
Slovénie,SVN,2018,24,338,NA,343,-5,-1.4577259475218658
Slovénie,SVN,2018,25,354,NA,346,8,2.312138728323699
Slovénie,SVN,2018,26,317,NA,328,-11,-3.353658536585366
Slovénie,SVN,2018,27,322,NA,346,-24,-6.9364161849710975
Slovénie,SVN,2018,28,318,NA,339,-21,-6.1946902654867255
Slovénie,SVN,2018,29,374,NA,347,27,7.780979827089338
Slovénie,SVN,2018,30,364,NA,345,19,5.507246376811594
Slovénie,SVN,2018,31,399,NA,355,44,12.394366197183098
Slovénie,SVN,2018,32,390,NA,345,45,13.043478260869565
Slovénie,SVN,2018,33,337,NA,349,-12,-3.4383954154727796
Slovénie,SVN,2018,34,381,NA,358,23,6.424581005586592
Slovénie,SVN,2018,35,365,NA,373,-8,-2.1447721179624666
Slovénie,SVN,2018,36,358,NA,343,15,4.373177842565598
Slovénie,SVN,2018,37,391,NA,365,26,7.123287671232877
Slovénie,SVN,2018,38,382,NA,368,14,3.804347826086957
Slovénie,SVN,2018,39,342,NA,357,-15,-4.201680672268908
Slovénie,SVN,2018,40,390,NA,386,4,1.0362694300518136
Slovénie,SVN,2018,41,371,NA,377,-6,-1.5915119363395225
Slovénie,SVN,2018,42,371,NA,374,-3,-0.8021390374331552
Slovénie,SVN,2018,43,417,NA,387,30,7.751937984496124
Slovénie,SVN,2018,44,393,NA,373,20,5.361930294906166
Slovénie,SVN,2018,45,348,NA,367,-19,-5.177111716621254
Slovénie,SVN,2018,46,392,NA,389,3,0.7712082262210797
Slovénie,SVN,2018,47,384,NA,380,4,1.0526315789473684
Slovénie,SVN,2018,48,406,NA,375,31,8.266666666666666
Slovénie,SVN,2018,49,407,NA,400,7,1.7500000000000002
Slovénie,SVN,2018,50,422,NA,386,36,9.32642487046632
Slovénie,SVN,2018,51,427,NA,412,15,3.640776699029126
Slovénie,SVN,2018,52,421,NA,436,-15,-3.4403669724770642
Suède,SWE,2016,1,1860,NA,1988,-128,-6.438631790744467
Suède,SWE,2016,2,1914,NA,1949,-35,-1.7957927142124166
Suède,SWE,2016,3,1958,NA,1950,8,0.41025641025641024
Suède,SWE,2016,4,2006,NA,1918,88,4.588112617309697
Suède,SWE,2016,5,1909,NA,1864,45,2.4141630901287554
Suède,SWE,2016,6,1837,NA,1896,-59,-3.1118143459915615
Suède,SWE,2016,7,1838,NA,1909,-71,-3.719224724986904
Suède,SWE,2016,8,1845,NA,1962,-117,-5.963302752293578
Suède,SWE,2016,9,1861,NA,1952,-91,-4.661885245901639
Suède,SWE,2016,10,1810,NA,1884,-74,-3.9278131634819533
Suède,SWE,2016,11,1800,NA,1892,-92,-4.862579281183932
Suède,SWE,2016,12,1795,NA,1779,16,0.8993816750983699
Suède,SWE,2016,13,1778,NA,1793,-15,-0.8365867261572784
Suède,SWE,2016,14,1705,NA,1796,-91,-5.066815144766148
Suède,SWE,2016,15,1773,NA,1722,51,2.961672473867596
Suède,SWE,2016,16,1771,NA,1740,31,1.7816091954022988
Suède,SWE,2016,17,1604,NA,1678,-74,-4.410011918951132
Suède,SWE,2016,18,1619,NA,1647,-28,-1.700060716454159
Suède,SWE,2016,19,1586,NA,1631,-45,-2.7590435315757205
Suède,SWE,2016,20,1565,NA,1548,17,1.0981912144702841
Suède,SWE,2016,21,1550,NA,1536,14,0.9114583333333334
Suède,SWE,2016,22,1541,NA,1546,-5,-0.3234152652005175
Suède,SWE,2016,23,1462,NA,1517,-55,-3.6255767963085037
Suède,SWE,2016,24,1541,NA,1504,37,2.4601063829787235
Suède,SWE,2016,25,1573,NA,1522,51,3.350854139290407
Suède,SWE,2016,26,1541,NA,1568,-27,-1.7219387755102038
Suède,SWE,2016,27,1549,NA,1556,-7,-0.4498714652956298
Suède,SWE,2016,28,1605,NA,1568,37,2.3596938775510203
Suède,SWE,2016,29,1616,NA,1584,32,2.0202020202020203
Suède,SWE,2016,30,1630,NA,1568,62,3.9540816326530615
Suède,SWE,2016,31,1574,NA,1581,-7,-0.4427577482605946
Suède,SWE,2016,32,1574,NA,1531,43,2.8086218158066623
Suède,SWE,2016,33,1567,NA,1526,41,2.686762778505898
Suède,SWE,2016,34,1567,NA,1533,34,2.217873450750163
Suède,SWE,2016,35,1686,NA,1620,66,4.074074074074074
Suède,SWE,2016,36,1556,NA,1552,4,0.25773195876288657
Suède,SWE,2016,37,1536,NA,1550,-14,-0.903225806451613
Suède,SWE,2016,38,1531,NA,1570,-39,-2.4840764331210194
Suède,SWE,2016,39,1601,NA,1584,17,1.073232323232323
Suède,SWE,2016,40,1598,NA,1638,-40,-2.442002442002442
Suède,SWE,2016,41,1662,NA,1682,-20,-1.1890606420927468
Suède,SWE,2016,42,1750,NA,1640,110,6.707317073170732
Suède,SWE,2016,43,1626,NA,1664,-38,-2.283653846153846
Suède,SWE,2016,44,1718,NA,1705,13,0.7624633431085044
Suède,SWE,2016,45,1717,NA,1666,51,3.061224489795918
Suède,SWE,2016,46,1771,NA,1685,86,5.103857566765579
Suède,SWE,2016,47,1702,NA,1662,40,2.406738868832732
Suède,SWE,2016,48,1790,NA,1750,40,2.2857142857142856
Suède,SWE,2016,49,1842,NA,1781,61,3.425042111173498
Suède,SWE,2016,50,1858,NA,1774,84,4.735062006764374
Suède,SWE,2016,51,1868,NA,1812,56,3.090507726269316
Suède,SWE,2016,52,2012,NA,1854,158,8.522114347357066
Suède,SWE,2017,1,2149,NA,1988,161,8.098591549295776
Suède,SWE,2017,2,2122,NA,1949,173,8.876346844535659
Suède,SWE,2017,3,2060,NA,1950,110,5.641025641025641
Suède,SWE,2017,4,1910,NA,1918,-8,-0.4171011470281543
Suède,SWE,2017,5,1883,NA,1864,19,1.01931330472103
Suède,SWE,2017,6,1881,NA,1896,-15,-0.7911392405063291
Suède,SWE,2017,7,2010,NA,1909,101,5.290728129910948
Suède,SWE,2017,8,2069,NA,1962,107,5.45361875637105
Suède,SWE,2017,9,1989,NA,1952,37,1.8954918032786885
Suède,SWE,2017,10,1830,NA,1884,-54,-2.8662420382165608
Suède,SWE,2017,11,1849,NA,1892,-43,-2.272727272727273
Suède,SWE,2017,12,1692,NA,1779,-87,-4.8903878583473865
Suède,SWE,2017,13,1782,NA,1793,-11,-0.6134969325153374
Suède,SWE,2017,14,1794,NA,1796,-2,-0.11135857461024498
Suède,SWE,2017,15,1719,NA,1722,-3,-0.17421602787456447
Suède,SWE,2017,16,1768,NA,1740,28,1.6091954022988506
Suède,SWE,2017,17,1772,NA,1678,94,5.601907032181168
Suède,SWE,2017,18,1696,NA,1647,49,2.9751062537947783
Suède,SWE,2017,19,1724,NA,1631,93,5.702023298589822
Suède,SWE,2017,20,1584,NA,1548,36,2.3255813953488373
Suède,SWE,2017,21,1646,NA,1536,110,7.161458333333333
Suède,SWE,2017,22,1620,NA,1546,74,4.786545924967658
Suède,SWE,2017,23,1549,NA,1517,32,2.109426499670402
Suède,SWE,2017,24,1590,NA,1504,86,5.718085106382978
Suède,SWE,2017,25,1491,NA,1522,-31,-2.036793692509855
Suède,SWE,2017,26,1587,NA,1568,19,1.211734693877551
Suède,SWE,2017,27,1549,NA,1556,-7,-0.4498714652956298
Suède,SWE,2017,28,1525,NA,1568,-43,-2.74234693877551
Suède,SWE,2017,29,1512,NA,1584,-72,-4.545454545454546
Suède,SWE,2017,30,1484,NA,1568,-84,-5.357142857142857
Suède,SWE,2017,31,1536,NA,1581,-45,-2.846299810246679
Suède,SWE,2017,32,1552,NA,1531,21,1.3716525146962768
Suède,SWE,2017,33,1545,NA,1526,19,1.2450851900393185
Suède,SWE,2017,34,1527,NA,1533,-6,-0.3913894324853229
Suède,SWE,2017,35,1568,NA,1620,-52,-3.2098765432098766
Suède,SWE,2017,36,1596,NA,1552,44,2.8350515463917527
Suède,SWE,2017,37,1590,NA,1550,40,2.5806451612903225
Suède,SWE,2017,38,1562,NA,1570,-8,-0.5095541401273885
Suède,SWE,2017,39,1532,NA,1584,-52,-3.2828282828282833
Suède,SWE,2017,40,1708,NA,1638,70,4.273504273504273
Suède,SWE,2017,41,1695,NA,1682,13,0.7728894173602854
Suède,SWE,2017,42,1648,NA,1640,8,0.4878048780487805
Suède,SWE,2017,43,1644,NA,1664,-20,-1.201923076923077
Suède,SWE,2017,44,1757,NA,1705,52,3.0498533724340176
Suède,SWE,2017,45,1608,NA,1666,-58,-3.481392557022809
Suède,SWE,2017,46,1753,NA,1685,68,4.035608308605341
Suède,SWE,2017,47,1700,NA,1662,38,2.286401925391095
Suède,SWE,2017,48,1740,NA,1750,-10,-0.5714285714285714
Suède,SWE,2017,49,1765,NA,1781,-16,-0.8983717012914094
Suède,SWE,2017,50,1797,NA,1774,23,1.2965050732807215
Suède,SWE,2017,51,1815,NA,1812,3,0.16556291390728478
Suède,SWE,2017,52,1929,NA,1854,75,4.0453074433656955
Suède,SWE,2018,1,1998,NA,1988,10,0.5030181086519114
Suède,SWE,2018,2,1941,NA,1949,-8,-0.4104669061056952
Suède,SWE,2018,3,1945,NA,1950,-5,-0.2564102564102564
Suède,SWE,2018,4,1928,NA,1918,10,0.5213764337851928
Suède,SWE,2018,5,1854,NA,1864,-10,-0.5364806866952789
Suède,SWE,2018,6,1983,NA,1896,87,4.588607594936709
Suède,SWE,2018,7,2024,NA,1909,115,6.024096385542169
Suède,SWE,2018,8,2116,NA,1962,154,7.8491335372069315
Suède,SWE,2018,9,2187,NA,1952,235,12.038934426229508
Suède,SWE,2018,10,2204,NA,1884,320,16.985138004246284
Suède,SWE,2018,11,2089,NA,1892,197,10.412262156448202
Suède,SWE,2018,12,1997,NA,1779,218,12.25407532321529
Suède,SWE,2018,13,1948,NA,1793,155,8.644729503625209
Suède,SWE,2018,14,1988,NA,1796,192,10.690423162583519
Suède,SWE,2018,15,1782,NA,1722,60,3.484320557491289
Suède,SWE,2018,16,1687,NA,1740,-53,-3.045977011494253
Suède,SWE,2018,17,1639,NA,1678,-39,-2.3241954707985695
Suède,SWE,2018,18,1661,NA,1647,14,0.8500303582270795
Suède,SWE,2018,19,1572,NA,1631,-59,-3.6174126302881664
Suède,SWE,2018,20,1486,NA,1548,-62,-4.0051679586563305
Suède,SWE,2018,21,1460,NA,1536,-76,-4.947916666666666
Suède,SWE,2018,22,1481,NA,1546,-65,-4.204398447606727
Suède,SWE,2018,23,1513,NA,1517,-4,-0.26367831245880025
Suède,SWE,2018,24,1441,NA,1504,-63,-4.1888297872340425
Suède,SWE,2018,25,1500,NA,1522,-22,-1.445466491458607
Suède,SWE,2018,26,1633,NA,1568,65,4.145408163265306
Suède,SWE,2018,27,1588,NA,1556,32,2.056555269922879
Suède,SWE,2018,28,1585,NA,1568,17,1.0841836734693877
Suède,SWE,2018,29,1724,NA,1584,140,8.83838383838384
Suède,SWE,2018,30,1642,NA,1568,74,4.719387755102041
Suède,SWE,2018,31,1723,NA,1581,142,8.981657179000631
Suède,SWE,2018,32,1450,NA,1531,-81,-5.290659699542783
Suède,SWE,2018,33,1505,NA,1526,-21,-1.3761467889908259
Suède,SWE,2018,34,1495,NA,1533,-38,-2.4787997390737115
Suède,SWE,2018,35,1584,NA,1620,-36,-2.2222222222222223
Suède,SWE,2018,36,1617,NA,1552,65,4.1881443298969065
Suède,SWE,2018,37,1516,NA,1550,-34,-2.193548387096774
Suède,SWE,2018,38,1645,NA,1570,75,4.777070063694268
Suède,SWE,2018,39,1553,NA,1584,-31,-1.9570707070707072
Suède,SWE,2018,40,1606,NA,1638,-32,-1.9536019536019535
Suède,SWE,2018,41,1715,NA,1682,33,1.9619500594530321
Suède,SWE,2018,42,1542,NA,1640,-98,-5.975609756097561
Suède,SWE,2018,43,1660,NA,1664,-4,-0.2403846153846154
Suède,SWE,2018,44,1706,NA,1705,1,0.05865102639296188
Suède,SWE,2018,45,1640,NA,1666,-26,-1.56062424969988
Suède,SWE,2018,46,1541,NA,1685,-144,-8.5459940652819
Suède,SWE,2018,47,1534,NA,1662,-128,-7.701564380264742
Suède,SWE,2018,48,1780,NA,1750,30,1.7142857142857144
Suède,SWE,2018,49,1787,NA,1781,6,0.3368893879842785
Suède,SWE,2018,50,1720,NA,1774,-54,-3.0439684329199546
Suède,SWE,2018,51,1741,NA,1812,-71,-3.9183222958057393
Suède,SWE,2018,52,1758,NA,1854,-96,-5.177993527508091
Suède,SWE,2019,1,1943,NA,1988,-45,-2.2635814889336014
Suède,SWE,2019,2,1820,NA,1949,-129,-6.618778860954336
Suède,SWE,2019,3,1839,NA,1950,-111,-5.6923076923076925
Suède,SWE,2019,4,1828,NA,1918,-90,-4.692387904066736
Suède,SWE,2019,5,1812,NA,1864,-52,-2.7896995708154506
Suède,SWE,2019,6,1882,NA,1896,-14,-0.7383966244725738
Suède,SWE,2019,7,1764,NA,1909,-145,-7.595599790466212
Suède,SWE,2019,8,1820,NA,1962,-142,-7.237512742099899
Suède,SWE,2019,9,1772,NA,1952,-180,-9.221311475409836
Suède,SWE,2019,10,1690,NA,1884,-194,-10.29723991507431
Suède,SWE,2019,11,1829,NA,1892,-63,-3.3298097251585626
Suède,SWE,2019,12,1632,NA,1779,-147,-8.263069139966273
Suède,SWE,2019,13,1665,NA,1793,-128,-7.138873396542109
Suède,SWE,2019,14,1698,NA,1796,-98,-5.456570155902004
Suède,SWE,2019,15,1612,NA,1722,-110,-6.3879210220673635
Suède,SWE,2019,16,1736,NA,1740,-4,-0.22988505747126436
Suède,SWE,2019,17,1698,NA,1678,20,1.1918951132300357
Suède,SWE,2019,18,1613,NA,1647,-34,-2.0643594414086217
Suède,SWE,2019,19,1643,NA,1631,12,0.7357449417535254
Suède,SWE,2019,20,1557,NA,1548,9,0.5813953488372093
Suède,SWE,2019,21,1486,NA,1536,-50,-3.2552083333333335
Suède,SWE,2019,22,1541,NA,1546,-5,-0.3234152652005175
Suède,SWE,2019,23,1544,NA,1517,27,1.7798286090969018
Suède,SWE,2019,24,1444,NA,1504,-60,-3.9893617021276597
Suède,SWE,2019,25,1526,NA,1522,4,0.2628120893561104
Suède,SWE,2019,26,1512,NA,1568,-56,-3.571428571428571
Suède,SWE,2019,27,1537,NA,1556,-19,-1.2210796915167095
Suède,SWE,2019,28,1558,NA,1568,-10,-0.6377551020408163
Suède,SWE,2019,29,1482,NA,1584,-102,-6.4393939393939394
Suède,SWE,2019,30,1514,NA,1568,-54,-3.4438775510204076
Suède,SWE,2019,31,1491,NA,1581,-90,-5.692599620493358
Suède,SWE,2019,32,1548,NA,1531,17,1.1103853690398433
Suède,SWE,2019,33,1486,NA,1526,-40,-2.621231979030144
Suède,SWE,2019,34,1542,NA,1533,9,0.5870841487279843
Suède,SWE,2019,35,1642,NA,1620,22,1.3580246913580247
Suède,SWE,2019,36,1441,NA,1552,-111,-7.1520618556701026
Suède,SWE,2019,37,1559,NA,1550,9,0.5806451612903226
Suède,SWE,2019,38,1540,NA,1570,-30,-1.910828025477707
Suède,SWE,2019,39,1648,NA,1584,64,4.040404040404041
Suède,SWE,2019,40,1638,NA,1638,0,0
Suède,SWE,2019,41,1654,NA,1682,-28,-1.6646848989298455
Suède,SWE,2019,42,1622,NA,1640,-18,-1.097560975609756
Suède,SWE,2019,43,1724,NA,1664,60,3.6057692307692304
Suède,SWE,2019,44,1638,NA,1705,-67,-3.929618768328446
Suède,SWE,2019,45,1698,NA,1666,32,1.9207683073229291
Suède,SWE,2019,46,1674,NA,1685,-11,-0.6528189910979229
Suède,SWE,2019,47,1712,NA,1662,50,3.0084235860409145
Suède,SWE,2019,48,1688,NA,1750,-62,-3.5428571428571427
Suède,SWE,2019,49,1731,NA,1781,-50,-2.807411566535654
Suède,SWE,2019,50,1719,NA,1774,-55,-3.100338218714769
Suède,SWE,2019,51,1826,NA,1812,14,0.772626931567329
Suède,SWE,2019,52,1718,NA,1854,-136,-7.335490830636461
Suède,SWE,2020,1,1819,0,1988,-169,-8.501006036217303
Suède,SWE,2020,2,1890,0,1949,-59,-3.0271934325295025
Suède,SWE,2020,3,1826,0,1950,-124,-6.3589743589743595
Suède,SWE,2020,4,1727,0,1918,-191,-9.958289885297186
Suède,SWE,2020,5,1847,0,1864,-17,-0.9120171673819742
Suède,SWE,2020,6,1726,0,1896,-170,-8.966244725738397
Suède,SWE,2020,7,1823,0,1909,-86,-4.504976427448926
Suède,SWE,2020,8,1774,0,1962,-188,-9.582059123343527
Suède,SWE,2020,9,1777,0,1952,-175,-8.96516393442623
Suède,SWE,2020,10,1825,0,1884,-59,-3.1316348195329087
Suède,SWE,2020,11,1728,7,1892,-164,-8.668076109936575
Suède,SWE,2020,12,1862,18,1779,83,4.665542439572794
Suède,SWE,2020,13,2034,121,1793,241,13.441160066926939
Suède,SWE,2020,14,2376,331,1796,580,32.29398663697104
Suède,SWE,2020,15,2562,442,1722,840,48.78048780487805
Suède,SWE,2020,16,2517,661,1740,777,44.6551724137931
Suède,SWE,2020,17,2263,694,1678,585,34.86293206197855
Suède,SWE,2020,18,2229,495,1647,582,35.33697632058288
Suède,SWE,2020,19,2170,487,1631,539,33.047210300429185
Suède,SWE,2020,20,1965,442,1548,417,26.937984496124027
Suède,SWE,2020,21,1871,331,1536,335,21.809895833333336
Suède,SWE,2020,22,1524,374,1546,-22,-1.423027166882277
Suède,SWE,2020,23,575,291,1517,-942,-62.09624258404747
