country_fr,iso3c,year,week,deaths_total,deaths_covid,baseline,diff_totals,diff_totals_perc
Autriche,AUT,2016,1,1634,NA,1835,-201,-11
Autriche,AUT,2016,2,1626,NA,1879,-253,-13.5
Autriche,AUT,2016,3,1608,NA,1774,-166,-9.4
Autriche,AUT,2016,4,1578,NA,1736,-158,-9.1
Autriche,AUT,2016,5,1609,NA,1814,-205,-11.3
Autriche,AUT,2016,6,1650,NA,1814,-164,-9
Autriche,AUT,2016,7,1621,NA,1768,-147,-8.3
Autriche,AUT,2016,8,1581,NA,1772,-191,-10.8
Autriche,AUT,2016,9,1714,NA,1799,-85,-4.7
Autriche,AUT,2016,10,1532,NA,1730,-198,-11.4
Autriche,AUT,2016,11,1516,NA,1698,-182,-10.7
Autriche,AUT,2016,12,1499,NA,1574,-75,-4.8
Autriche,AUT,2016,13,1598,NA,1626,-28,-1.7
Autriche,AUT,2016,14,1562,NA,1581,-19,-1.2
Autriche,AUT,2016,15,1520,NA,1542,-22,-1.4
Autriche,AUT,2016,16,1413,NA,1501,-88,-5.9
Autriche,AUT,2016,17,1460,NA,1451,9,0.6
Autriche,AUT,2016,18,1447,NA,1468,-21,-1.4
Autriche,AUT,2016,19,1486,NA,1436,50,3.5
Autriche,AUT,2016,20,1453,NA,1464,-11,-0.8
Autriche,AUT,2016,21,1505,NA,1428,77,5.4
Autriche,AUT,2016,22,1402,NA,1442,-40,-2.8
Autriche,AUT,2016,23,1360,NA,1406,-46,-3.3
Autriche,AUT,2016,24,1348,NA,1429,-81,-5.7
Autriche,AUT,2016,25,1452,NA,1438,14,1
Autriche,AUT,2016,26,1338,NA,1406,-68,-4.8
Autriche,AUT,2016,27,1328,NA,1422,-94,-6.6
Autriche,AUT,2016,28,1323,NA,1353,-30,-2.2
Autriche,AUT,2016,29,1458,NA,1468,-10,-0.7
Autriche,AUT,2016,30,1424,NA,1453,-29,-2
Autriche,AUT,2016,31,1390,NA,1520,-130,-8.6
Autriche,AUT,2016,32,1359,NA,1408,-49,-3.5
Autriche,AUT,2016,33,1394,NA,1403,-9,-0.6
Autriche,AUT,2016,34,1408,NA,1448,-40,-2.8
Autriche,AUT,2016,35,1414,NA,1414,0,0
Autriche,AUT,2016,36,1380,NA,1374,6,0.4
Autriche,AUT,2016,37,1392,NA,1419,-27,-1.9
Autriche,AUT,2016,38,1376,NA,1414,-38,-2.7
Autriche,AUT,2016,39,1442,NA,1487,-45,-3
Autriche,AUT,2016,40,1469,NA,1514,-45,-3
Autriche,AUT,2016,41,1556,NA,1546,10,0.6
Autriche,AUT,2016,42,1607,NA,1511,96,6.4
Autriche,AUT,2016,43,1522,NA,1512,10,0.7
Autriche,AUT,2016,44,1484,NA,1533,-49,-3.2
Autriche,AUT,2016,45,1541,NA,1522,19,1.2
Autriche,AUT,2016,46,1616,NA,1559,57,3.7
Autriche,AUT,2016,47,1550,NA,1551,-1,-0.1
Autriche,AUT,2016,48,1601,NA,1561,40,2.6
Autriche,AUT,2016,49,1619,NA,1626,-7,-0.4
Autriche,AUT,2016,50,1670,NA,1629,41,2.5
Autriche,AUT,2016,51,1847,NA,1682,165,9.8
Autriche,AUT,2016,52,2160,NA,1783,377,21.1
Autriche,AUT,2017,1,2293,NA,1835,458,25
Autriche,AUT,2017,2,2340,NA,1879,461,24.5
Autriche,AUT,2017,3,2060,NA,1774,286,16.1
Autriche,AUT,2017,4,1938,NA,1736,202,11.6
Autriche,AUT,2017,5,2045,NA,1814,231,12.7
Autriche,AUT,2017,6,1874,NA,1814,60,3.3
Autriche,AUT,2017,7,1750,NA,1768,-18,-1
Autriche,AUT,2017,8,1807,NA,1772,35,2
Autriche,AUT,2017,9,1696,NA,1799,-103,-5.7
Autriche,AUT,2017,10,1614,NA,1730,-116,-6.7
Autriche,AUT,2017,11,1542,NA,1698,-156,-9.2
Autriche,AUT,2017,12,1535,NA,1574,-39,-2.5
Autriche,AUT,2017,13,1489,NA,1626,-137,-8.4
Autriche,AUT,2017,14,1537,NA,1581,-44,-2.8
Autriche,AUT,2017,15,1532,NA,1542,-10,-0.6
Autriche,AUT,2017,16,1475,NA,1501,-26,-1.7
Autriche,AUT,2017,17,1440,NA,1451,-11,-0.8
Autriche,AUT,2017,18,1527,NA,1468,59,4
Autriche,AUT,2017,19,1434,NA,1436,-2,-0.1
Autriche,AUT,2017,20,1501,NA,1464,37,2.5
Autriche,AUT,2017,21,1327,NA,1428,-101,-7.1
Autriche,AUT,2017,22,1456,NA,1442,14,1
Autriche,AUT,2017,23,1312,NA,1406,-94,-6.7
Autriche,AUT,2017,24,1421,NA,1429,-8,-0.6
Autriche,AUT,2017,25,1476,NA,1438,38,2.6
Autriche,AUT,2017,26,1419,NA,1406,13,0.9
Autriche,AUT,2017,27,1413,NA,1422,-9,-0.6
Autriche,AUT,2017,28,1346,NA,1353,-7,-0.5
Autriche,AUT,2017,29,1475,NA,1468,7,0.5
Autriche,AUT,2017,30,1375,NA,1453,-78,-5.4
Autriche,AUT,2017,31,1616,NA,1520,96,6.3
Autriche,AUT,2017,32,1334,NA,1408,-74,-5.3
Autriche,AUT,2017,33,1380,NA,1403,-23,-1.6
Autriche,AUT,2017,34,1472,NA,1448,24,1.7
Autriche,AUT,2017,35,1329,NA,1414,-85,-6
Autriche,AUT,2017,36,1318,NA,1374,-56,-4.1
Autriche,AUT,2017,37,1426,NA,1419,7,0.5
Autriche,AUT,2017,38,1407,NA,1414,-7,-0.5
Autriche,AUT,2017,39,1496,NA,1487,9,0.6
Autriche,AUT,2017,40,1481,NA,1514,-33,-2.2
Autriche,AUT,2017,41,1529,NA,1546,-17,-1.1
Autriche,AUT,2017,42,1453,NA,1511,-58,-3.8
Autriche,AUT,2017,43,1489,NA,1512,-23,-1.5
Autriche,AUT,2017,44,1551,NA,1533,18,1.2
Autriche,AUT,2017,45,1490,NA,1522,-32,-2.1
Autriche,AUT,2017,46,1505,NA,1559,-54,-3.5
Autriche,AUT,2017,47,1570,NA,1551,19,1.2
Autriche,AUT,2017,48,1531,NA,1561,-30,-1.9
Autriche,AUT,2017,49,1632,NA,1626,6,0.4
Autriche,AUT,2017,50,1554,NA,1629,-75,-4.6
Autriche,AUT,2017,51,1653,NA,1682,-29,-1.7
Autriche,AUT,2017,52,1646,NA,1783,-137,-7.7
Autriche,AUT,2018,1,1767,NA,1835,-68,-3.7
Autriche,AUT,2018,2,1842,NA,1879,-37,-2
Autriche,AUT,2018,3,1786,NA,1774,12,0.7
Autriche,AUT,2018,4,1714,NA,1736,-22,-1.3
Autriche,AUT,2018,5,1870,NA,1814,56,3.1
Autriche,AUT,2018,6,1938,NA,1814,124,6.8
Autriche,AUT,2018,7,1881,NA,1768,113,6.4
Autriche,AUT,2018,8,1951,NA,1772,179,10.1
Autriche,AUT,2018,9,2021,NA,1799,222,12.3
Autriche,AUT,2018,10,1965,NA,1730,235,13.6
Autriche,AUT,2018,11,1946,NA,1698,248,14.6
Autriche,AUT,2018,12,1641,NA,1574,67,4.3
Autriche,AUT,2018,13,1766,NA,1626,140,8.6
Autriche,AUT,2018,14,1617,NA,1581,36,2.3
Autriche,AUT,2018,15,1560,NA,1542,18,1.2
Autriche,AUT,2018,16,1557,NA,1501,56,3.7
Autriche,AUT,2018,17,1383,NA,1451,-68,-4.7
Autriche,AUT,2018,18,1434,NA,1468,-34,-2.3
Autriche,AUT,2018,19,1372,NA,1436,-64,-4.5
Autriche,AUT,2018,20,1342,NA,1464,-122,-8.3
Autriche,AUT,2018,21,1383,NA,1428,-45,-3.2
Autriche,AUT,2018,22,1415,NA,1442,-27,-1.9
Autriche,AUT,2018,23,1433,NA,1406,27,1.9
Autriche,AUT,2018,24,1392,NA,1429,-37,-2.6
Autriche,AUT,2018,25,1401,NA,1438,-37,-2.6
Autriche,AUT,2018,26,1414,NA,1406,8,0.6
Autriche,AUT,2018,27,1441,NA,1422,19,1.3
Autriche,AUT,2018,28,1404,NA,1353,51,3.8
Autriche,AUT,2018,29,1511,NA,1468,43,2.9
Autriche,AUT,2018,30,1455,NA,1453,2,0.1
Autriche,AUT,2018,31,1615,NA,1520,95,6.2
Autriche,AUT,2018,32,1532,NA,1408,124,8.8
Autriche,AUT,2018,33,1430,NA,1403,27,1.9
Autriche,AUT,2018,34,1460,NA,1448,12,0.8
Autriche,AUT,2018,35,1414,NA,1414,0,0
Autriche,AUT,2018,36,1376,NA,1374,2,0.1
Autriche,AUT,2018,37,1452,NA,1419,33,2.3
Autriche,AUT,2018,38,1421,NA,1414,7,0.5
Autriche,AUT,2018,39,1436,NA,1487,-51,-3.4
Autriche,AUT,2018,40,1553,NA,1514,39,2.6
Autriche,AUT,2018,41,1509,NA,1546,-37,-2.4
Autriche,AUT,2018,42,1488,NA,1511,-23,-1.5
Autriche,AUT,2018,43,1491,NA,1512,-21,-1.4
Autriche,AUT,2018,44,1561,NA,1533,28,1.8
Autriche,AUT,2018,45,1501,NA,1522,-21,-1.4
Autriche,AUT,2018,46,1556,NA,1559,-3,-0.2
Autriche,AUT,2018,47,1531,NA,1551,-20,-1.3
Autriche,AUT,2018,48,1525,NA,1561,-36,-2.3
Autriche,AUT,2018,49,1656,NA,1626,30,1.8
Autriche,AUT,2018,50,1626,NA,1629,-3,-0.2
Autriche,AUT,2018,51,1639,NA,1682,-43,-2.6
Autriche,AUT,2018,52,1689,NA,1783,-94,-5.3
Autriche,AUT,2019,1,1647,NA,1835,-188,-10.2
Autriche,AUT,2019,2,1709,NA,1879,-170,-9
Autriche,AUT,2019,3,1641,NA,1774,-133,-7.5
Autriche,AUT,2019,4,1713,NA,1736,-23,-1.3
Autriche,AUT,2019,5,1732,NA,1814,-82,-4.5
Autriche,AUT,2019,6,1796,NA,1814,-18,-1
Autriche,AUT,2019,7,1820,NA,1768,52,2.9
Autriche,AUT,2019,8,1751,NA,1772,-21,-1.2
Autriche,AUT,2019,9,1764,NA,1799,-35,-1.9
Autriche,AUT,2019,10,1811,NA,1730,81,4.7
Autriche,AUT,2019,11,1790,NA,1698,92,5.4
Autriche,AUT,2019,12,1619,NA,1574,45,2.9
Autriche,AUT,2019,13,1651,NA,1626,25,1.5
Autriche,AUT,2019,14,1607,NA,1581,26,1.6
Autriche,AUT,2019,15,1556,NA,1542,14,0.9
Autriche,AUT,2019,16,1558,NA,1501,57,3.8
Autriche,AUT,2019,17,1521,NA,1451,70,4.8
Autriche,AUT,2019,18,1462,NA,1468,-6,-0.4
Autriche,AUT,2019,19,1453,NA,1436,17,1.2
Autriche,AUT,2019,20,1558,NA,1464,94,6.4
Autriche,AUT,2019,21,1497,NA,1428,69,4.8
Autriche,AUT,2019,22,1495,NA,1442,53,3.7
Autriche,AUT,2019,23,1520,NA,1406,114,8.1
Autriche,AUT,2019,24,1554,NA,1429,125,8.7
Autriche,AUT,2019,25,1424,NA,1438,-14,-1
Autriche,AUT,2019,26,1454,NA,1406,48,3.4
Autriche,AUT,2019,27,1507,NA,1422,85,6
Autriche,AUT,2019,28,1338,NA,1353,-15,-1.1
Autriche,AUT,2019,29,1430,NA,1468,-38,-2.6
Autriche,AUT,2019,30,1557,NA,1453,104,7.2
Autriche,AUT,2019,31,1457,NA,1520,-63,-4.1
Autriche,AUT,2019,32,1406,NA,1408,-2,-0.1
Autriche,AUT,2019,33,1407,NA,1403,4,0.3
Autriche,AUT,2019,34,1453,NA,1448,5,0.3
Autriche,AUT,2019,35,1501,NA,1414,87,6.2
Autriche,AUT,2019,36,1423,NA,1374,49,3.6
Autriche,AUT,2019,37,1407,NA,1419,-12,-0.8
Autriche,AUT,2019,38,1452,NA,1414,38,2.7
Autriche,AUT,2019,39,1574,NA,1487,87,5.9
Autriche,AUT,2019,40,1555,NA,1514,41,2.7
Autriche,AUT,2019,41,1592,NA,1546,46,3
Autriche,AUT,2019,42,1497,NA,1511,-14,-0.9
Autriche,AUT,2019,43,1545,NA,1512,33,2.2
Autriche,AUT,2019,44,1536,NA,1533,3,0.2
Autriche,AUT,2019,45,1555,NA,1522,33,2.2
Autriche,AUT,2019,46,1558,NA,1559,-1,-0.1
Autriche,AUT,2019,47,1553,NA,1551,2,0.1
Autriche,AUT,2019,48,1586,NA,1561,25,1.6
Autriche,AUT,2019,49,1599,NA,1626,-27,-1.7
Autriche,AUT,2019,50,1667,NA,1629,38,2.3
Autriche,AUT,2019,51,1591,NA,1682,-91,-5.4
Autriche,AUT,2019,52,1636,NA,1783,-147,-8.2
Autriche,AUT,2020,1,1609,0,1835,-226,-12.3
Autriche,AUT,2020,2,1702,0,1879,-177,-9.4
Autriche,AUT,2020,3,1797,0,1774,23,1.3
Autriche,AUT,2020,4,1779,0,1736,43,2.5
Autriche,AUT,2020,5,1947,0,1814,133,7.3
Autriche,AUT,2020,6,1679,0,1814,-135,-7.4
Autriche,AUT,2020,7,1721,0,1768,-47,-2.7
Autriche,AUT,2020,8,1716,0,1772,-56,-3.2
Autriche,AUT,2020,9,1768,0,1799,-31,-1.7
Autriche,AUT,2020,10,1745,0,1730,15,0.9
Autriche,AUT,2020,11,1718,3,1698,20,1.2
Autriche,AUT,2020,12,1836,22,1574,262,16.6
Autriche,AUT,2020,13,1764,83,1626,138,8.5
Autriche,AUT,2020,14,1828,112,1581,247,15.6
Autriche,AUT,2020,15,1794,148,1542,252,16.3
Autriche,AUT,2020,16,1703,94,1501,202,13.5
Autriche,AUT,2020,17,1587,87,1451,136,9.4
Autriche,AUT,2020,18,1479,51,1468,11,0.7
Autriche,AUT,2020,19,1514,20,1436,78,5.4
Autriche,AUT,2020,20,1483,9,1464,19,1.3
Autriche,AUT,2020,21,1471,12,1428,43,3
Autriche,AUT,2020,22,1396,27,1442,-46,-3.2
Belgique,BEL,2016,1,2244,NA,2373,-129,-5.4
Belgique,BEL,2016,2,2234,NA,2408,-174,-7.2
Belgique,BEL,2016,3,2295,NA,2397,-102,-4.3
Belgique,BEL,2016,4,2263,NA,2400,-137,-5.7
Belgique,BEL,2016,5,2180,NA,2476,-296,-12
Belgique,BEL,2016,6,2127,NA,2429,-302,-12.4
Belgique,BEL,2016,7,2121,NA,2432,-311,-12.8
Belgique,BEL,2016,8,2230,NA,2416,-186,-7.7
Belgique,BEL,2016,9,2336,NA,2520,-184,-7.3
Belgique,BEL,2016,10,2264,NA,2452,-188,-7.7
Belgique,BEL,2016,11,2248,NA,2336,-88,-3.8
Belgique,BEL,2016,12,2364,NA,2308,56,2.4
Belgique,BEL,2016,13,2273,NA,2216,57,2.6
Belgique,BEL,2016,14,2080,NA,2109,-29,-1.4
Belgique,BEL,2016,15,2160,NA,2064,96,4.7
Belgique,BEL,2016,16,2049,NA,2026,23,1.1
Belgique,BEL,2016,17,1996,NA,2018,-22,-1.1
Belgique,BEL,2016,18,2087,NA,2014,73,3.6
Belgique,BEL,2016,19,2065,NA,2022,43,2.1
Belgique,BEL,2016,20,1926,NA,1982,-56,-2.8
Belgique,BEL,2016,21,1946,NA,1975,-29,-1.5
Belgique,BEL,2016,22,1885,NA,1938,-53,-2.7
Belgique,BEL,2016,23,1856,NA,1862,-6,-0.3
Belgique,BEL,2016,24,1851,NA,1825,26,1.4
Belgique,BEL,2016,25,1920,NA,1928,-8,-0.4
Belgique,BEL,2016,26,1846,NA,1899,-53,-2.8
Belgique,BEL,2016,27,1899,NA,1954,-55,-2.8
Belgique,BEL,2016,28,1933,NA,1850,83,4.5
Belgique,BEL,2016,29,2030,NA,1932,98,5.1
Belgique,BEL,2016,30,1917,NA,2060,-143,-6.9
Belgique,BEL,2016,31,1801,NA,1912,-111,-5.8
Belgique,BEL,2016,32,1788,NA,1845,-57,-3.1
Belgique,BEL,2016,33,1976,NA,1856,120,6.5
Belgique,BEL,2016,34,2120,NA,1938,182,9.4
Belgique,BEL,2016,35,1866,NA,1905,-39,-2
Belgique,BEL,2016,36,1835,NA,1866,-31,-1.7
Belgique,BEL,2016,37,1938,NA,1851,87,4.7
Belgique,BEL,2016,38,1769,NA,1892,-123,-6.5
Belgique,BEL,2016,39,1906,NA,1902,4,0.2
Belgique,BEL,2016,40,1904,NA,1968,-64,-3.3
Belgique,BEL,2016,41,2065,NA,2020,45,2.2
Belgique,BEL,2016,42,2041,NA,1992,49,2.5
Belgique,BEL,2016,43,2025,NA,1980,45,2.3
Belgique,BEL,2016,44,2088,NA,1956,132,6.7
Belgique,BEL,2016,45,2093,NA,2020,73,3.6
Belgique,BEL,2016,46,2177,NA,2072,105,5.1
Belgique,BEL,2016,47,2143,NA,2126,17,0.8
Belgique,BEL,2016,48,2191,NA,2125,66,3.1
Belgique,BEL,2016,49,2221,NA,2208,13,0.6
Belgique,BEL,2016,50,2221,NA,2248,-27,-1.2
Belgique,BEL,2016,51,2321,NA,2298,23,1
Belgique,BEL,2016,52,2418,NA,2293,125,5.5
Belgique,BEL,2017,1,2557,NA,2373,184,7.8
Belgique,BEL,2017,2,2735,NA,2408,327,13.6
Belgique,BEL,2017,3,2645,NA,2397,248,10.3
Belgique,BEL,2017,4,2691,NA,2400,291,12.1
Belgique,BEL,2017,5,2950,NA,2476,474,19.1
Belgique,BEL,2017,6,2691,NA,2429,262,10.8
Belgique,BEL,2017,7,2631,NA,2432,199,8.2
Belgique,BEL,2017,8,2389,NA,2416,-27,-1.1
Belgique,BEL,2017,9,2315,NA,2520,-205,-8.1
Belgique,BEL,2017,10,2138,NA,2452,-314,-12.8
Belgique,BEL,2017,11,2036,NA,2336,-300,-12.8
Belgique,BEL,2017,12,2106,NA,2308,-202,-8.8
Belgique,BEL,2017,13,2068,NA,2216,-148,-6.7
Belgique,BEL,2017,14,1969,NA,2109,-140,-6.6
Belgique,BEL,2017,15,1954,NA,2064,-110,-5.3
Belgique,BEL,2017,16,1917,NA,2026,-109,-5.4
Belgique,BEL,2017,17,2079,NA,2018,61,3
Belgique,BEL,2017,18,2091,NA,2014,77,3.8
Belgique,BEL,2017,19,2009,NA,2022,-13,-0.6
Belgique,BEL,2017,20,2110,NA,1982,128,6.5
Belgique,BEL,2017,21,2009,NA,1975,34,1.7
Belgique,BEL,2017,22,1981,NA,1938,43,2.2
Belgique,BEL,2017,23,1815,NA,1862,-47,-2.5
Belgique,BEL,2017,24,1868,NA,1825,43,2.4
Belgique,BEL,2017,25,2101,NA,1928,173,9
Belgique,BEL,2017,26,1821,NA,1899,-78,-4.1
Belgique,BEL,2017,27,1901,NA,1954,-53,-2.7
Belgique,BEL,2017,28,1847,NA,1850,-3,-0.2
Belgique,BEL,2017,29,1827,NA,1932,-105,-5.4
Belgique,BEL,2017,30,1897,NA,2060,-163,-7.9
Belgique,BEL,2017,31,1808,NA,1912,-104,-5.4
Belgique,BEL,2017,32,1826,NA,1845,-19,-1
Belgique,BEL,2017,33,1784,NA,1856,-72,-3.9
Belgique,BEL,2017,34,1951,NA,1938,13,0.7
Belgique,BEL,2017,35,1924,NA,1905,19,1
Belgique,BEL,2017,36,1883,NA,1866,17,0.9
Belgique,BEL,2017,37,1823,NA,1851,-28,-1.5
Belgique,BEL,2017,38,1908,NA,1892,16,0.8
Belgique,BEL,2017,39,1963,NA,1902,61,3.2
Belgique,BEL,2017,40,1955,NA,1968,-13,-0.7
Belgique,BEL,2017,41,2059,NA,2020,39,1.9
Belgique,BEL,2017,42,2007,NA,1992,15,0.8
Belgique,BEL,2017,43,1913,NA,1980,-67,-3.4
Belgique,BEL,2017,44,1892,NA,1956,-64,-3.3
Belgique,BEL,2017,45,1939,NA,2020,-81,-4
Belgique,BEL,2017,46,2078,NA,2072,6,0.3
Belgique,BEL,2017,47,2114,NA,2126,-12,-0.6
Belgique,BEL,2017,48,2080,NA,2125,-45,-2.1
Belgique,BEL,2017,49,2276,NA,2208,68,3.1
Belgique,BEL,2017,50,2325,NA,2248,77,3.4
Belgique,BEL,2017,51,2272,NA,2298,-26,-1.1
Belgique,BEL,2017,52,2350,NA,2293,57,2.5
Belgique,BEL,2018,1,2382,NA,2373,9,0.4
Belgique,BEL,2018,2,2317,NA,2408,-91,-3.8
Belgique,BEL,2018,3,2336,NA,2397,-61,-2.5
Belgique,BEL,2018,4,2253,NA,2400,-147,-6.1
Belgique,BEL,2018,5,2355,NA,2476,-121,-4.9
Belgique,BEL,2018,6,2353,NA,2429,-76,-3.1
Belgique,BEL,2018,7,2565,NA,2432,133,5.5
Belgique,BEL,2018,8,2628,NA,2416,212,8.8
Belgique,BEL,2018,9,3002,NA,2520,482,19.1
Belgique,BEL,2018,10,3016,NA,2452,564,23
Belgique,BEL,2018,11,2724,NA,2336,388,16.6
Belgique,BEL,2018,12,2594,NA,2308,286,12.4
Belgique,BEL,2018,13,2460,NA,2216,244,11
Belgique,BEL,2018,14,2203,NA,2109,94,4.5
Belgique,BEL,2018,15,2175,NA,2064,111,5.4
Belgique,BEL,2018,16,2044,NA,2026,18,0.9
Belgique,BEL,2018,17,1953,NA,2018,-65,-3.2
Belgique,BEL,2018,18,1867,NA,2014,-147,-7.3
Belgique,BEL,2018,19,1980,NA,2022,-42,-2.1
Belgique,BEL,2018,20,1860,NA,1982,-122,-6.2
Belgique,BEL,2018,21,1951,NA,1975,-24,-1.2
Belgique,BEL,2018,22,1953,NA,1938,15,0.8
Belgique,BEL,2018,23,1811,NA,1862,-51,-2.7
Belgique,BEL,2018,24,1734,NA,1825,-91,-5
Belgique,BEL,2018,25,1779,NA,1928,-149,-7.7
Belgique,BEL,2018,26,1950,NA,1899,51,2.7
Belgique,BEL,2018,27,2080,NA,1954,126,6.4
Belgique,BEL,2018,28,1833,NA,1850,-17,-0.9
Belgique,BEL,2018,29,1988,NA,1932,56,2.9
Belgique,BEL,2018,30,2107,NA,2060,47,2.3
Belgique,BEL,2018,31,2125,NA,1912,213,11.1
Belgique,BEL,2018,32,2000,NA,1845,155,8.4
Belgique,BEL,2018,33,1887,NA,1856,31,1.7
Belgique,BEL,2018,34,1824,NA,1938,-114,-5.9
Belgique,BEL,2018,35,1825,NA,1905,-80,-4.2
Belgique,BEL,2018,36,1909,NA,1866,43,2.3
Belgique,BEL,2018,37,1811,NA,1851,-40,-2.2
Belgique,BEL,2018,38,1970,NA,1892,78,4.1
Belgique,BEL,2018,39,1831,NA,1902,-71,-3.7
Belgique,BEL,2018,40,1965,NA,1968,-3,-0.2
Belgique,BEL,2018,41,2006,NA,2020,-14,-0.7
Belgique,BEL,2018,42,1957,NA,1992,-35,-1.8
Belgique,BEL,2018,43,1918,NA,1980,-62,-3.1
Belgique,BEL,2018,44,1907,NA,1956,-49,-2.5
Belgique,BEL,2018,45,2049,NA,2020,29,1.4
Belgique,BEL,2018,46,2017,NA,2072,-55,-2.7
Belgique,BEL,2018,47,2060,NA,2126,-66,-3.1
Belgique,BEL,2018,48,2107,NA,2125,-18,-0.8
Belgique,BEL,2018,49,2173,NA,2208,-35,-1.6
Belgique,BEL,2018,50,2233,NA,2248,-15,-0.7
Belgique,BEL,2018,51,2263,NA,2298,-35,-1.5
Belgique,BEL,2018,52,2251,NA,2293,-42,-1.8
Belgique,BEL,2019,1,2308,NA,2373,-65,-2.7
Belgique,BEL,2019,2,2347,NA,2408,-61,-2.5
Belgique,BEL,2019,3,2312,NA,2397,-85,-3.5
Belgique,BEL,2019,4,2395,NA,2400,-5,-0.2
Belgique,BEL,2019,5,2421,NA,2476,-55,-2.2
Belgique,BEL,2019,6,2544,NA,2429,115,4.7
Belgique,BEL,2019,7,2409,NA,2432,-23,-0.9
Belgique,BEL,2019,8,2418,NA,2416,2,0.1
Belgique,BEL,2019,9,2428,NA,2520,-92,-3.7
Belgique,BEL,2019,10,2389,NA,2452,-63,-2.6
Belgique,BEL,2019,11,2335,NA,2336,-1,-0
Belgique,BEL,2019,12,2167,NA,2308,-141,-6.1
Belgique,BEL,2019,13,2063,NA,2216,-153,-6.9
Belgique,BEL,2019,14,2183,NA,2109,74,3.5
Belgique,BEL,2019,15,1969,NA,2064,-95,-4.6
Belgique,BEL,2019,16,2095,NA,2026,69,3.4
Belgique,BEL,2019,17,2046,NA,2018,28,1.4
Belgique,BEL,2019,18,2011,NA,2014,-3,-0.1
Belgique,BEL,2019,19,2034,NA,2022,12,0.6
Belgique,BEL,2019,20,2034,NA,1982,52,2.6
Belgique,BEL,2019,21,1995,NA,1975,20,1
Belgique,BEL,2019,22,1933,NA,1938,-5,-0.3
Belgique,BEL,2019,23,1966,NA,1862,104,5.6
Belgique,BEL,2019,24,1847,NA,1825,22,1.2
Belgique,BEL,2019,25,1913,NA,1928,-15,-0.8
Belgique,BEL,2019,26,1980,NA,1899,81,4.3
Belgique,BEL,2019,27,1935,NA,1954,-19,-1
Belgique,BEL,2019,28,1788,NA,1850,-62,-3.4
Belgique,BEL,2019,29,1882,NA,1932,-50,-2.6
Belgique,BEL,2019,30,2318,NA,2060,258,12.5
Belgique,BEL,2019,31,1916,NA,1912,4,0.2
Belgique,BEL,2019,32,1766,NA,1845,-79,-4.3
Belgique,BEL,2019,33,1777,NA,1856,-79,-4.3
Belgique,BEL,2019,34,1859,NA,1938,-79,-4.1
Belgique,BEL,2019,35,2006,NA,1905,101,5.3
Belgique,BEL,2019,36,1838,NA,1866,-28,-1.5
Belgique,BEL,2019,37,1833,NA,1851,-18,-1
Belgique,BEL,2019,38,1923,NA,1892,31,1.6
Belgique,BEL,2019,39,1906,NA,1902,4,0.2
Belgique,BEL,2019,40,2048,NA,1968,80,4.1
Belgique,BEL,2019,41,1951,NA,2020,-69,-3.4
Belgique,BEL,2019,42,1961,NA,1992,-31,-1.6
Belgique,BEL,2019,43,2065,NA,1980,85,4.3
Belgique,BEL,2019,44,1935,NA,1956,-21,-1.1
Belgique,BEL,2019,45,2001,NA,2020,-19,-0.9
Belgique,BEL,2019,46,2014,NA,2072,-58,-2.8
Belgique,BEL,2019,47,2187,NA,2126,61,2.9
Belgique,BEL,2019,48,2122,NA,2125,-3,-0.1
Belgique,BEL,2019,49,2161,NA,2208,-47,-2.1
Belgique,BEL,2019,50,2213,NA,2248,-35,-1.6
Belgique,BEL,2019,51,2337,NA,2298,39,1.7
Belgique,BEL,2019,52,2152,NA,2293,-141,-6.1
Belgique,BEL,2020,1,2225,0,2373,-148,-6.2
Belgique,BEL,2020,2,2380,0,2408,-28,-1.2
Belgique,BEL,2020,3,2303,0,2397,-94,-3.9
Belgique,BEL,2020,4,2191,0,2400,-209,-8.7
Belgique,BEL,2020,5,2354,0,2476,-122,-4.9
Belgique,BEL,2020,6,2161,0,2429,-268,-11
Belgique,BEL,2020,7,2298,0,2432,-134,-5.5
Belgique,BEL,2020,8,2289,0,2416,-127,-5.3
Belgique,BEL,2020,9,2232,0,2520,-288,-11.4
Belgique,BEL,2020,10,2204,0,2452,-248,-10.1
Belgique,BEL,2020,11,2217,5,2336,-119,-5.1
Belgique,BEL,2020,12,2545,83,2308,237,10.3
Belgique,BEL,2020,13,3177,425,2216,961,43.4
Belgique,BEL,2020,14,4018,1119,2109,1909,90.5
Belgique,BEL,2020,15,4276,2271,2064,2212,107.2
Belgique,BEL,2020,16,3695,1925,2026,1669,82.4
Belgique,BEL,2020,17,3023,1379,2018,1005,49.8
Belgique,BEL,2020,18,2404,717,2014,390,19.4
Belgique,BEL,2020,19,2375,783,2022,353,17.5
Belgique,BEL,2020,20,2031,373,1982,49,2.5
Belgique,BEL,2020,21,2054,232,1975,79,4
Belgique,BEL,2020,22,1952,174,1938,14,0.7
Belgique,BEL,2020,23,1764,123,1862,-98,-5.3
Bulgarie,BGR,2016,1,2445,NA,2605,-160,-6.1
Bulgarie,BGR,2016,2,2281,NA,2590,-309,-11.9
Bulgarie,BGR,2016,3,2276,NA,2555,-279,-10.9
Bulgarie,BGR,2016,4,2367,NA,2550,-183,-7.2
Bulgarie,BGR,2016,5,2304,NA,2492,-188,-7.5
Bulgarie,BGR,2016,6,2225,NA,2318,-93,-4
Bulgarie,BGR,2016,7,2100,NA,2283,-183,-8
Bulgarie,BGR,2016,8,2095,NA,2226,-131,-5.9
Bulgarie,BGR,2016,9,1959,NA,2211,-252,-11.4
Bulgarie,BGR,2016,10,2088,NA,2216,-128,-5.8
Bulgarie,BGR,2016,11,2100,NA,2145,-45,-2.1
Bulgarie,BGR,2016,12,2020,NA,2112,-92,-4.4
Bulgarie,BGR,2016,13,2106,NA,2086,20,1
Bulgarie,BGR,2016,14,2123,NA,2098,25,1.2
Bulgarie,BGR,2016,15,1927,NA,2026,-99,-4.9
Bulgarie,BGR,2016,16,1945,NA,2022,-77,-3.8
Bulgarie,BGR,2016,17,1964,NA,2032,-68,-3.3
Bulgarie,BGR,2016,18,2036,NA,1976,60,3
Bulgarie,BGR,2016,19,2044,NA,2008,36,1.8
Bulgarie,BGR,2016,20,1989,NA,1966,23,1.2
Bulgarie,BGR,2016,21,2006,NA,1970,36,1.8
Bulgarie,BGR,2016,22,1991,NA,1982,9,0.5
Bulgarie,BGR,2016,23,1784,NA,1906,-122,-6.4
Bulgarie,BGR,2016,24,2012,NA,1923,89,4.6
Bulgarie,BGR,2016,25,2145,NA,1976,169,8.6
Bulgarie,BGR,2016,26,1958,NA,1988,-30,-1.5
Bulgarie,BGR,2016,27,1806,NA,1917,-111,-5.8
Bulgarie,BGR,2016,28,1970,NA,1918,52,2.7
Bulgarie,BGR,2016,29,1824,NA,1865,-41,-2.2
Bulgarie,BGR,2016,30,1906,NA,1940,-34,-1.8
Bulgarie,BGR,2016,31,1970,NA,1917,53,2.8
Bulgarie,BGR,2016,32,1799,NA,1916,-117,-6.1
Bulgarie,BGR,2016,33,1810,NA,1840,-30,-1.6
Bulgarie,BGR,2016,34,1859,NA,1844,15,0.8
Bulgarie,BGR,2016,35,1765,NA,1815,-50,-2.8
Bulgarie,BGR,2016,36,1757,NA,1774,-17,-1
Bulgarie,BGR,2016,37,1821,NA,1840,-19,-1
Bulgarie,BGR,2016,38,1796,NA,1794,2,0.1
Bulgarie,BGR,2016,39,1866,NA,1822,44,2.4
Bulgarie,BGR,2016,40,2019,NA,1976,43,2.2
Bulgarie,BGR,2016,41,2113,NA,2000,113,5.7
Bulgarie,BGR,2016,42,2104,NA,2068,36,1.7
Bulgarie,BGR,2016,43,2133,NA,2048,85,4.2
Bulgarie,BGR,2016,44,2074,NA,2061,13,0.6
Bulgarie,BGR,2016,45,2139,NA,2106,33,1.6
Bulgarie,BGR,2016,46,2129,NA,2099,30,1.4
Bulgarie,BGR,2016,47,2091,NA,2072,19,0.9
Bulgarie,BGR,2016,48,2151,NA,2121,30,1.4
Bulgarie,BGR,2016,49,2300,NA,2191,109,5
Bulgarie,BGR,2016,50,2281,NA,2211,70,3.2
Bulgarie,BGR,2016,51,2431,NA,2236,195,8.7
Bulgarie,BGR,2016,52,2811,NA,2403,408,17
Bulgarie,BGR,2017,1,3169,NA,2605,564,21.7
Bulgarie,BGR,2017,2,3222,NA,2590,632,24.4
Bulgarie,BGR,2017,3,2814,NA,2555,259,10.1
Bulgarie,BGR,2017,4,2627,NA,2550,77,3
Bulgarie,BGR,2017,5,2525,NA,2492,33,1.3
Bulgarie,BGR,2017,6,2347,NA,2318,29,1.3
Bulgarie,BGR,2017,7,2352,NA,2283,69,3
Bulgarie,BGR,2017,8,2312,NA,2226,86,3.9
Bulgarie,BGR,2017,9,2138,NA,2211,-73,-3.3
Bulgarie,BGR,2017,10,2230,NA,2216,14,0.6
Bulgarie,BGR,2017,11,2117,NA,2145,-28,-1.3
Bulgarie,BGR,2017,12,2115,NA,2112,3,0.1
Bulgarie,BGR,2017,13,2098,NA,2086,12,0.6
Bulgarie,BGR,2017,14,2079,NA,2098,-19,-0.9
Bulgarie,BGR,2017,15,2025,NA,2026,-1,-0
Bulgarie,BGR,2017,16,2116,NA,2022,94,4.6
Bulgarie,BGR,2017,17,2036,NA,2032,4,0.2
Bulgarie,BGR,2017,18,1952,NA,1976,-24,-1.2
Bulgarie,BGR,2017,19,1983,NA,2008,-25,-1.2
Bulgarie,BGR,2017,20,1977,NA,1966,11,0.6
Bulgarie,BGR,2017,21,1981,NA,1970,11,0.6
Bulgarie,BGR,2017,22,2055,NA,1982,73,3.7
Bulgarie,BGR,2017,23,1958,NA,1906,52,2.7
Bulgarie,BGR,2017,24,1912,NA,1923,-11,-0.6
Bulgarie,BGR,2017,25,1957,NA,1976,-19,-1
Bulgarie,BGR,2017,26,2291,NA,1988,303,15.2
Bulgarie,BGR,2017,27,2008,NA,1917,91,4.7
Bulgarie,BGR,2017,28,1920,NA,1918,2,0.1
Bulgarie,BGR,2017,29,1795,NA,1865,-70,-3.8
Bulgarie,BGR,2017,30,1914,NA,1940,-26,-1.3
Bulgarie,BGR,2017,31,1943,NA,1917,26,1.4
Bulgarie,BGR,2017,32,2059,NA,1916,143,7.5
Bulgarie,BGR,2017,33,1769,NA,1840,-71,-3.9
Bulgarie,BGR,2017,34,1761,NA,1844,-83,-4.5
Bulgarie,BGR,2017,35,1804,NA,1815,-11,-0.6
Bulgarie,BGR,2017,36,1762,NA,1774,-12,-0.7
Bulgarie,BGR,2017,37,1942,NA,1840,102,5.5
Bulgarie,BGR,2017,38,1702,NA,1794,-92,-5.1
Bulgarie,BGR,2017,39,1702,NA,1822,-120,-6.6
Bulgarie,BGR,2017,40,1929,NA,1976,-47,-2.4
Bulgarie,BGR,2017,41,1958,NA,2000,-42,-2.1
Bulgarie,BGR,2017,42,2064,NA,2068,-4,-0.2
Bulgarie,BGR,2017,43,2054,NA,2048,6,0.3
Bulgarie,BGR,2017,44,2061,NA,2061,0,0
Bulgarie,BGR,2017,45,2016,NA,2106,-90,-4.3
Bulgarie,BGR,2017,46,2105,NA,2099,6,0.3
Bulgarie,BGR,2017,47,2072,NA,2072,0,0
Bulgarie,BGR,2017,48,2052,NA,2121,-69,-3.3
Bulgarie,BGR,2017,49,2015,NA,2191,-176,-8
Bulgarie,BGR,2017,50,2103,NA,2211,-108,-4.9
Bulgarie,BGR,2017,51,2033,NA,2236,-203,-9.1
Bulgarie,BGR,2017,52,2253,NA,2403,-150,-6.2
Bulgarie,BGR,2018,1,2274,NA,2605,-331,-12.7
Bulgarie,BGR,2018,2,2166,NA,2590,-424,-16.4
Bulgarie,BGR,2018,3,2374,NA,2555,-181,-7.1
Bulgarie,BGR,2018,4,2360,NA,2550,-190,-7.5
Bulgarie,BGR,2018,5,2564,NA,2492,72,2.9
Bulgarie,BGR,2018,6,2456,NA,2318,138,6
Bulgarie,BGR,2018,7,2380,NA,2283,97,4.2
Bulgarie,BGR,2018,8,2234,NA,2226,8,0.4
Bulgarie,BGR,2018,9,2471,NA,2211,260,11.8
Bulgarie,BGR,2018,10,2382,NA,2216,166,7.5
Bulgarie,BGR,2018,11,2239,NA,2145,94,4.4
Bulgarie,BGR,2018,12,2164,NA,2112,52,2.5
Bulgarie,BGR,2018,13,2057,NA,2086,-29,-1.4
Bulgarie,BGR,2018,14,2075,NA,2098,-23,-1.1
Bulgarie,BGR,2018,15,2061,NA,2026,35,1.7
Bulgarie,BGR,2018,16,1991,NA,2022,-31,-1.5
Bulgarie,BGR,2018,17,2076,NA,2032,44,2.2
Bulgarie,BGR,2018,18,1934,NA,1976,-42,-2.1
Bulgarie,BGR,2018,19,1887,NA,2008,-121,-6
Bulgarie,BGR,2018,20,1920,NA,1966,-46,-2.3
Bulgarie,BGR,2018,21,1897,NA,1970,-73,-3.7
Bulgarie,BGR,2018,22,1917,NA,1982,-65,-3.3
Bulgarie,BGR,2018,23,1951,NA,1906,45,2.4
Bulgarie,BGR,2018,24,1774,NA,1923,-149,-7.7
Bulgarie,BGR,2018,25,1776,NA,1976,-200,-10.1
Bulgarie,BGR,2018,26,1793,NA,1988,-195,-9.8
Bulgarie,BGR,2018,27,1900,NA,1917,-17,-0.9
Bulgarie,BGR,2018,28,1963,NA,1918,45,2.3
Bulgarie,BGR,2018,29,1975,NA,1865,110,5.9
Bulgarie,BGR,2018,30,1976,NA,1940,36,1.9
Bulgarie,BGR,2018,31,1902,NA,1917,-15,-0.8
Bulgarie,BGR,2018,32,1911,NA,1916,-5,-0.3
Bulgarie,BGR,2018,33,1860,NA,1840,20,1.1
Bulgarie,BGR,2018,34,1822,NA,1844,-22,-1.2
Bulgarie,BGR,2018,35,1828,NA,1815,13,0.7
Bulgarie,BGR,2018,36,1842,NA,1774,68,3.8
Bulgarie,BGR,2018,37,1845,NA,1840,5,0.3
Bulgarie,BGR,2018,38,1885,NA,1794,91,5.1
Bulgarie,BGR,2018,39,1892,NA,1822,70,3.8
Bulgarie,BGR,2018,40,2068,NA,1976,92,4.7
Bulgarie,BGR,2018,41,2040,NA,2000,40,2
Bulgarie,BGR,2018,42,2132,NA,2068,64,3.1
Bulgarie,BGR,2018,43,2092,NA,2048,44,2.1
Bulgarie,BGR,2018,44,2069,NA,2061,8,0.4
Bulgarie,BGR,2018,45,2073,NA,2106,-33,-1.6
Bulgarie,BGR,2018,46,2135,NA,2099,36,1.7
Bulgarie,BGR,2018,47,2166,NA,2072,94,4.5
Bulgarie,BGR,2018,48,2209,NA,2121,88,4.1
Bulgarie,BGR,2018,49,2322,NA,2191,131,6
Bulgarie,BGR,2018,50,2346,NA,2211,135,6.1
Bulgarie,BGR,2018,51,2345,NA,2236,109,4.9
Bulgarie,BGR,2018,52,2431,NA,2403,28,1.2
Bulgarie,BGR,2019,1,2533,NA,2605,-72,-2.8
Bulgarie,BGR,2019,2,2692,NA,2590,102,3.9
Bulgarie,BGR,2019,3,2756,NA,2555,201,7.9
Bulgarie,BGR,2019,4,2848,NA,2550,298,11.7
Bulgarie,BGR,2019,5,2573,NA,2492,81,3.3
Bulgarie,BGR,2019,6,2245,NA,2318,-73,-3.1
Bulgarie,BGR,2019,7,2300,NA,2283,17,0.7
Bulgarie,BGR,2019,8,2264,NA,2226,38,1.7
Bulgarie,BGR,2019,9,2275,NA,2211,64,2.9
Bulgarie,BGR,2019,10,2166,NA,2216,-50,-2.3
Bulgarie,BGR,2019,11,2123,NA,2145,-22,-1
Bulgarie,BGR,2019,12,2148,NA,2112,36,1.7
Bulgarie,BGR,2019,13,2081,NA,2086,-5,-0.2
Bulgarie,BGR,2019,14,2114,NA,2098,16,0.8
Bulgarie,BGR,2019,15,2092,NA,2026,66,3.3
Bulgarie,BGR,2019,16,2036,NA,2022,14,0.7
Bulgarie,BGR,2019,17,2051,NA,2032,19,0.9
Bulgarie,BGR,2019,18,1980,NA,1976,4,0.2
Bulgarie,BGR,2019,19,2120,NA,2008,112,5.6
Bulgarie,BGR,2019,20,1980,NA,1966,14,0.7
Bulgarie,BGR,2019,21,1998,NA,1970,28,1.4
Bulgarie,BGR,2019,22,1967,NA,1982,-15,-0.8
Bulgarie,BGR,2019,23,1932,NA,1906,26,1.4
Bulgarie,BGR,2019,24,1994,NA,1923,71,3.7
Bulgarie,BGR,2019,25,2026,NA,1976,50,2.5
Bulgarie,BGR,2019,26,1908,NA,1988,-80,-4
Bulgarie,BGR,2019,27,1954,NA,1917,37,1.9
Bulgarie,BGR,2019,28,1820,NA,1918,-98,-5.1
Bulgarie,BGR,2019,29,1867,NA,1865,2,0.1
Bulgarie,BGR,2019,30,1963,NA,1940,23,1.2
Bulgarie,BGR,2019,31,1854,NA,1917,-63,-3.3
Bulgarie,BGR,2019,32,1896,NA,1916,-20,-1
Bulgarie,BGR,2019,33,1920,NA,1840,80,4.3
Bulgarie,BGR,2019,34,1936,NA,1844,92,5
Bulgarie,BGR,2019,35,1863,NA,1815,48,2.6
Bulgarie,BGR,2019,36,1734,NA,1774,-40,-2.3
Bulgarie,BGR,2019,37,1753,NA,1840,-87,-4.7
Bulgarie,BGR,2019,38,1791,NA,1794,-3,-0.2
Bulgarie,BGR,2019,39,1827,NA,1822,5,0.3
Bulgarie,BGR,2019,40,1887,NA,1976,-89,-4.5
Bulgarie,BGR,2019,41,1888,NA,2000,-112,-5.6
Bulgarie,BGR,2019,42,1971,NA,2068,-97,-4.7
Bulgarie,BGR,2019,43,1911,NA,2048,-137,-6.7
Bulgarie,BGR,2019,44,2039,NA,2061,-22,-1.1
Bulgarie,BGR,2019,45,2194,NA,2106,88,4.2
Bulgarie,BGR,2019,46,2026,NA,2099,-73,-3.5
Bulgarie,BGR,2019,47,1958,NA,2072,-114,-5.5
Bulgarie,BGR,2019,48,2071,NA,2121,-50,-2.4
Bulgarie,BGR,2019,49,2128,NA,2191,-63,-2.9
Bulgarie,BGR,2019,50,2113,NA,2211,-98,-4.4
Bulgarie,BGR,2019,51,2135,NA,2236,-101,-4.5
Bulgarie,BGR,2019,52,2117,NA,2403,-286,-11.9
Bulgarie,BGR,2020,1,2095,NA,2605,-510,-19.6
Bulgarie,BGR,2020,2,2268,NA,2590,-322,-12.4
Bulgarie,BGR,2020,3,2169,NA,2555,-386,-15.1
Bulgarie,BGR,2020,4,2383,NA,2550,-167,-6.5
Bulgarie,BGR,2020,5,2418,NA,2492,-74,-3
Bulgarie,BGR,2020,6,2331,NA,2318,13,0.6
Bulgarie,BGR,2020,7,2294,NA,2283,11,0.5
Bulgarie,BGR,2020,8,2149,NA,2226,-77,-3.5
Bulgarie,BGR,2020,9,2161,NA,2211,-50,-2.3
Bulgarie,BGR,2020,10,2027,0,2216,-189,-8.5
Bulgarie,BGR,2020,11,2054,2,2145,-91,-4.2
Bulgarie,BGR,2020,12,2020,1,2112,-92,-4.4
Bulgarie,BGR,2020,13,2046,5,2086,-40,-1.9
Bulgarie,BGR,2020,14,2005,14,2098,-93,-4.4
Bulgarie,BGR,2020,15,1996,10,2026,-30,-1.5
Bulgarie,BGR,2020,16,1992,11,2022,-30,-1.5
Bulgarie,BGR,2020,17,1951,15,2032,-81,-4
Bulgarie,BGR,2020,18,1867,20,1976,-109,-5.5
Bulgarie,BGR,2020,19,1888,15,2008,-120,-6
Bulgarie,BGR,2020,20,2057,19,1966,91,4.6
Bulgarie,BGR,2020,21,1857,18,1970,-113,-5.7
Bulgarie,BGR,2020,22,1777,14,1982,-205,-10.3
Bulgarie,BGR,2020,23,1873,20,1906,-33,-1.7
Bulgarie,BGR,2020,24,1907,12,1923,-16,-0.8
Suisse,CHE,2016,1,1340,NA,1480,-140,-9.5
Suisse,CHE,2016,2,1243,NA,1476,-233,-15.8
Suisse,CHE,2016,3,1323,NA,1480,-157,-10.6
Suisse,CHE,2016,4,1351,NA,1452,-101,-7
Suisse,CHE,2016,5,1345,NA,1436,-91,-6.3
Suisse,CHE,2016,6,1340,NA,1464,-124,-8.5
Suisse,CHE,2016,7,1313,NA,1432,-119,-8.3
Suisse,CHE,2016,8,1380,NA,1442,-62,-4.3
Suisse,CHE,2016,9,1320,NA,1470,-150,-10.2
Suisse,CHE,2016,10,1355,NA,1422,-67,-4.7
Suisse,CHE,2016,11,1278,NA,1350,-72,-5.3
Suisse,CHE,2016,12,1294,NA,1316,-22,-1.7
Suisse,CHE,2016,13,1269,NA,1280,-11,-0.9
Suisse,CHE,2016,14,1242,NA,1299,-57,-4.4
Suisse,CHE,2016,15,1224,NA,1237,-13,-1.1
Suisse,CHE,2016,16,1139,NA,1214,-75,-6.2
Suisse,CHE,2016,17,1175,NA,1194,-19,-1.6
Suisse,CHE,2016,18,1172,NA,1216,-44,-3.6
Suisse,CHE,2016,19,1149,NA,1205,-56,-4.6
Suisse,CHE,2016,20,1176,NA,1180,-4,-0.3
Suisse,CHE,2016,21,1227,NA,1227,0,0
Suisse,CHE,2016,22,1150,NA,1170,-20,-1.7
Suisse,CHE,2016,23,1104,NA,1160,-56,-4.8
Suisse,CHE,2016,24,1113,NA,1131,-18,-1.6
Suisse,CHE,2016,25,1237,NA,1192,45,3.8
Suisse,CHE,2016,26,1172,NA,1190,-18,-1.5
Suisse,CHE,2016,27,1092,NA,1165,-73,-6.3
Suisse,CHE,2016,28,1164,NA,1138,26,2.3
Suisse,CHE,2016,29,1235,NA,1204,31,2.6
Suisse,CHE,2016,30,1181,NA,1196,-15,-1.3
Suisse,CHE,2016,31,1113,NA,1179,-66,-5.6
Suisse,CHE,2016,32,1150,NA,1152,-2,-0.2
Suisse,CHE,2016,33,1166,NA,1156,10,0.9
Suisse,CHE,2016,34,1131,NA,1184,-53,-4.5
Suisse,CHE,2016,35,1137,NA,1164,-27,-2.3
Suisse,CHE,2016,36,1184,NA,1172,12,1
Suisse,CHE,2016,37,1103,NA,1194,-91,-7.6
Suisse,CHE,2016,38,1180,NA,1230,-50,-4.1
Suisse,CHE,2016,39,1212,NA,1226,-14,-1.1
Suisse,CHE,2016,40,1286,NA,1260,26,2.1
Suisse,CHE,2016,41,1271,NA,1262,9,0.7
Suisse,CHE,2016,42,1277,NA,1249,28,2.2
Suisse,CHE,2016,43,1230,NA,1246,-16,-1.3
Suisse,CHE,2016,44,1313,NA,1240,73,5.9
Suisse,CHE,2016,45,1286,NA,1281,5,0.4
Suisse,CHE,2016,46,1353,NA,1304,49,3.8
Suisse,CHE,2016,47,1193,NA,1280,-87,-6.8
Suisse,CHE,2016,48,1331,NA,1356,-25,-1.8
Suisse,CHE,2016,49,1294,NA,1323,-29,-2.2
Suisse,CHE,2016,50,1301,NA,1345,-44,-3.3
Suisse,CHE,2016,51,1446,NA,1406,40,2.8
Suisse,CHE,2016,52,1589,NA,1410,179,12.7
Suisse,CHE,2017,1,1678,NA,1480,198,13.4
Suisse,CHE,2017,2,1731,NA,1476,255,17.3
Suisse,CHE,2017,3,1746,NA,1480,266,18
Suisse,CHE,2017,4,1657,NA,1452,205,14.1
Suisse,CHE,2017,5,1564,NA,1436,128,8.9
Suisse,CHE,2017,6,1592,NA,1464,128,8.7
Suisse,CHE,2017,7,1402,NA,1432,-30,-2.1
Suisse,CHE,2017,8,1383,NA,1442,-59,-4.1
Suisse,CHE,2017,9,1395,NA,1470,-75,-5.1
Suisse,CHE,2017,10,1348,NA,1422,-74,-5.2
Suisse,CHE,2017,11,1262,NA,1350,-88,-6.5
Suisse,CHE,2017,12,1239,NA,1316,-77,-5.9
Suisse,CHE,2017,13,1183,NA,1280,-97,-7.6
Suisse,CHE,2017,14,1234,NA,1299,-65,-5
Suisse,CHE,2017,15,1201,NA,1237,-36,-2.9
Suisse,CHE,2017,16,1181,NA,1214,-33,-2.7
Suisse,CHE,2017,17,1223,NA,1194,29,2.4
Suisse,CHE,2017,18,1210,NA,1216,-6,-0.5
Suisse,CHE,2017,19,1204,NA,1205,-1,-0.1
Suisse,CHE,2017,20,1207,NA,1180,27,2.3
Suisse,CHE,2017,21,1186,NA,1227,-41,-3.3
Suisse,CHE,2017,22,1126,NA,1170,-44,-3.8
Suisse,CHE,2017,23,1108,NA,1160,-52,-4.5
Suisse,CHE,2017,24,1120,NA,1131,-11,-1
Suisse,CHE,2017,25,1196,NA,1192,4,0.3
Suisse,CHE,2017,26,1166,NA,1190,-24,-2
Suisse,CHE,2017,27,1158,NA,1165,-7,-0.6
Suisse,CHE,2017,28,1087,NA,1138,-51,-4.5
Suisse,CHE,2017,29,1151,NA,1204,-53,-4.4
Suisse,CHE,2017,30,1121,NA,1196,-75,-6.3
Suisse,CHE,2017,31,1200,NA,1179,21,1.8
Suisse,CHE,2017,32,1099,NA,1152,-53,-4.6
Suisse,CHE,2017,33,1128,NA,1156,-28,-2.4
Suisse,CHE,2017,34,1207,NA,1184,23,1.9
Suisse,CHE,2017,35,1164,NA,1164,0,0
Suisse,CHE,2017,36,1153,NA,1172,-19,-1.6
Suisse,CHE,2017,37,1190,NA,1194,-4,-0.3
Suisse,CHE,2017,38,1265,NA,1230,35,2.8
Suisse,CHE,2017,39,1243,NA,1226,17,1.4
Suisse,CHE,2017,40,1295,NA,1260,35,2.8
Suisse,CHE,2017,41,1268,NA,1262,6,0.5
Suisse,CHE,2017,42,1210,NA,1249,-39,-3.1
Suisse,CHE,2017,43,1214,NA,1246,-32,-2.6
Suisse,CHE,2017,44,1153,NA,1240,-87,-7
Suisse,CHE,2017,45,1312,NA,1281,31,2.4
Suisse,CHE,2017,46,1251,NA,1304,-53,-4.1
Suisse,CHE,2017,47,1318,NA,1280,38,3
Suisse,CHE,2017,48,1396,NA,1356,40,2.9
Suisse,CHE,2017,49,1390,NA,1323,67,5.1
Suisse,CHE,2017,50,1357,NA,1345,12,0.9
Suisse,CHE,2017,51,1456,NA,1406,50,3.6
Suisse,CHE,2017,52,1375,NA,1410,-35,-2.5
Suisse,CHE,2018,1,1561,NA,1480,81,5.5
Suisse,CHE,2018,2,1541,NA,1476,65,4.4
Suisse,CHE,2018,3,1494,NA,1480,14,0.9
Suisse,CHE,2018,4,1397,NA,1452,-55,-3.8
Suisse,CHE,2018,5,1397,NA,1436,-39,-2.7
Suisse,CHE,2018,6,1441,NA,1464,-23,-1.6
Suisse,CHE,2018,7,1458,NA,1432,26,1.8
Suisse,CHE,2018,8,1478,NA,1442,36,2.5
Suisse,CHE,2018,9,1636,NA,1470,166,11.3
Suisse,CHE,2018,10,1532,NA,1422,110,7.7
Suisse,CHE,2018,11,1482,NA,1350,132,9.8
Suisse,CHE,2018,12,1380,NA,1316,64,4.9
Suisse,CHE,2018,13,1348,NA,1280,68,5.3
Suisse,CHE,2018,14,1339,NA,1299,40,3.1
Suisse,CHE,2018,15,1300,NA,1237,63,5.1
Suisse,CHE,2018,16,1229,NA,1214,15,1.2
Suisse,CHE,2018,17,1147,NA,1194,-47,-3.9
Suisse,CHE,2018,18,1226,NA,1216,10,0.8
Suisse,CHE,2018,19,1200,NA,1205,-5,-0.4
Suisse,CHE,2018,20,1117,NA,1180,-63,-5.3
Suisse,CHE,2018,21,1223,NA,1227,-4,-0.3
Suisse,CHE,2018,22,1159,NA,1170,-11,-0.9
Suisse,CHE,2018,23,1178,NA,1160,18,1.6
Suisse,CHE,2018,24,1119,NA,1131,-12,-1.1
Suisse,CHE,2018,25,1127,NA,1192,-65,-5.5
Suisse,CHE,2018,26,1181,NA,1190,-9,-0.8
Suisse,CHE,2018,27,1152,NA,1165,-13,-1.1
Suisse,CHE,2018,28,1078,NA,1138,-60,-5.3
Suisse,CHE,2018,29,1223,NA,1204,19,1.6
Suisse,CHE,2018,30,1222,NA,1196,26,2.2
Suisse,CHE,2018,31,1264,NA,1179,85,7.2
Suisse,CHE,2018,32,1222,NA,1152,70,6.1
Suisse,CHE,2018,33,1187,NA,1156,31,2.7
Suisse,CHE,2018,34,1145,NA,1184,-39,-3.3
Suisse,CHE,2018,35,1206,NA,1164,42,3.6
Suisse,CHE,2018,36,1178,NA,1172,6,0.5
Suisse,CHE,2018,37,1230,NA,1194,36,3
Suisse,CHE,2018,38,1177,NA,1230,-53,-4.3
Suisse,CHE,2018,39,1212,NA,1226,-14,-1.1
Suisse,CHE,2018,40,1225,NA,1260,-35,-2.8
Suisse,CHE,2018,41,1233,NA,1262,-29,-2.3
Suisse,CHE,2018,42,1211,NA,1249,-38,-3
Suisse,CHE,2018,43,1233,NA,1246,-13,-1
Suisse,CHE,2018,44,1272,NA,1240,32,2.6
Suisse,CHE,2018,45,1263,NA,1281,-18,-1.4
Suisse,CHE,2018,46,1248,NA,1304,-56,-4.3
Suisse,CHE,2018,47,1280,NA,1280,0,0
Suisse,CHE,2018,48,1321,NA,1356,-35,-2.6
Suisse,CHE,2018,49,1389,NA,1323,66,5
Suisse,CHE,2018,50,1356,NA,1345,11,0.8
Suisse,CHE,2018,51,1322,NA,1406,-84,-6
Suisse,CHE,2018,52,1349,NA,1410,-61,-4.3
Suisse,CHE,2019,1,1341,NA,1480,-139,-9.4
Suisse,CHE,2019,2,1389,NA,1476,-87,-5.9
Suisse,CHE,2019,3,1358,NA,1480,-122,-8.2
Suisse,CHE,2019,4,1403,NA,1452,-49,-3.4
Suisse,CHE,2019,5,1439,NA,1436,3,0.2
Suisse,CHE,2019,6,1481,NA,1464,17,1.2
Suisse,CHE,2019,7,1555,NA,1432,123,8.6
Suisse,CHE,2019,8,1527,NA,1442,85,5.9
Suisse,CHE,2019,9,1527,NA,1470,57,3.9
Suisse,CHE,2019,10,1452,NA,1422,30,2.1
Suisse,CHE,2019,11,1379,NA,1350,29,2.1
Suisse,CHE,2019,12,1351,NA,1316,35,2.7
Suisse,CHE,2019,13,1322,NA,1280,42,3.3
Suisse,CHE,2019,14,1382,NA,1299,83,6.4
Suisse,CHE,2019,15,1222,NA,1237,-15,-1.2
Suisse,CHE,2019,16,1308,NA,1214,94,7.7
Suisse,CHE,2019,17,1233,NA,1194,39,3.3
Suisse,CHE,2019,18,1256,NA,1216,40,3.3
Suisse,CHE,2019,19,1266,NA,1205,61,5.1
Suisse,CHE,2019,20,1218,NA,1180,38,3.2
Suisse,CHE,2019,21,1271,NA,1227,44,3.6
Suisse,CHE,2019,22,1245,NA,1170,75,6.4
Suisse,CHE,2019,23,1251,NA,1160,91,7.8
Suisse,CHE,2019,24,1171,NA,1131,40,3.5
Suisse,CHE,2019,25,1210,NA,1192,18,1.5
Suisse,CHE,2019,26,1243,NA,1190,53,4.5
Suisse,CHE,2019,27,1258,NA,1165,93,8
Suisse,CHE,2019,28,1225,NA,1138,87,7.6
Suisse,CHE,2019,29,1206,NA,1204,2,0.2
Suisse,CHE,2019,30,1260,NA,1196,64,5.4
Suisse,CHE,2019,31,1139,NA,1179,-40,-3.4
Suisse,CHE,2019,32,1138,NA,1152,-14,-1.2
Suisse,CHE,2019,33,1142,NA,1156,-14,-1.2
Suisse,CHE,2019,34,1252,NA,1184,68,5.7
Suisse,CHE,2019,35,1147,NA,1164,-17,-1.5
Suisse,CHE,2019,36,1172,NA,1172,0,0
Suisse,CHE,2019,37,1252,NA,1194,58,4.9
Suisse,CHE,2019,38,1296,NA,1230,66,5.4
Suisse,CHE,2019,39,1237,NA,1226,11,0.9
Suisse,CHE,2019,40,1234,NA,1260,-26,-2.1
Suisse,CHE,2019,41,1278,NA,1262,16,1.3
Suisse,CHE,2019,42,1298,NA,1249,49,3.9
Suisse,CHE,2019,43,1307,NA,1246,61,4.9
Suisse,CHE,2019,44,1224,NA,1240,-16,-1.3
Suisse,CHE,2019,45,1264,NA,1281,-17,-1.3
Suisse,CHE,2019,46,1365,NA,1304,61,4.7
Suisse,CHE,2019,47,1331,NA,1280,51,4
Suisse,CHE,2019,48,1375,NA,1356,19,1.4
Suisse,CHE,2019,49,1218,NA,1323,-105,-7.9
Suisse,CHE,2019,50,1367,NA,1345,22,1.6
Suisse,CHE,2019,51,1401,NA,1406,-5,-0.4
Suisse,CHE,2019,52,1329,NA,1410,-81,-5.7
Suisse,CHE,2020,1,1305,0,1480,-175,-11.8
Suisse,CHE,2020,2,1354,0,1476,-122,-8.3
Suisse,CHE,2020,3,1400,0,1480,-80,-5.4
Suisse,CHE,2020,4,1406,0,1452,-46,-3.2
Suisse,CHE,2020,5,1415,0,1436,-21,-1.5
Suisse,CHE,2020,6,1377,0,1464,-87,-5.9
Suisse,CHE,2020,7,1371,0,1432,-61,-4.3
Suisse,CHE,2020,8,1352,0,1442,-90,-6.2
Suisse,CHE,2020,9,1331,0,1470,-139,-9.5
Suisse,CHE,2020,10,1340,2,1422,-82,-5.8
Suisse,CHE,2020,11,1378,12,1350,28,2.1
Suisse,CHE,2020,12,1513,52,1316,197,15
Suisse,CHE,2020,13,1598,229,1280,318,24.8
Suisse,CHE,2020,14,1843,289,1299,544,41.9
Suisse,CHE,2020,15,1613,274,1237,376,30.4
Suisse,CHE,2020,16,1541,283,1214,327,26.9
Suisse,CHE,2020,17,1345,211,1194,151,12.6
Suisse,CHE,2020,18,1216,124,1216,0,0
Suisse,CHE,2020,19,1143,66,1205,-62,-5.1
Suisse,CHE,2020,20,1102,60,1180,-78,-6.6
Suisse,CHE,2020,21,1134,39,1227,-93,-7.6
Suisse,CHE,2020,22,999,15,1170,-171,-14.6
Suisse,CHE,2020,23,1002,4,1160,-158,-13.6
République tchèque,CZE,2016,1,2222,NA,2362,-140,-5.9
République tchèque,CZE,2016,2,2054,NA,2320,-266,-11.5
République tchèque,CZE,2016,3,2175,NA,2387,-212,-8.9
République tchèque,CZE,2016,4,2116,NA,2358,-242,-10.3
République tchèque,CZE,2016,5,2137,NA,2362,-225,-9.5
République tchèque,CZE,2016,6,2245,NA,2434,-189,-7.8
République tchèque,CZE,2016,7,2160,NA,2441,-281,-11.5
République tchèque,CZE,2016,8,2214,NA,2455,-241,-9.8
République tchèque,CZE,2016,9,2235,NA,2430,-195,-8
République tchèque,CZE,2016,10,2096,NA,2424,-328,-13.5
République tchèque,CZE,2016,11,2155,NA,2341,-186,-7.9
République tchèque,CZE,2016,12,2148,NA,2264,-116,-5.1
République tchèque,CZE,2016,13,2191,NA,2193,-2,-0.1
République tchèque,CZE,2016,14,2138,NA,2150,-12,-0.6
République tchèque,CZE,2016,15,2075,NA,2118,-43,-2
République tchèque,CZE,2016,16,1949,NA,2037,-88,-4.3
République tchèque,CZE,2016,17,2114,NA,2090,24,1.1
République tchèque,CZE,2016,18,1982,NA,2024,-42,-2.1
République tchèque,CZE,2016,19,2001,NA,2032,-31,-1.5
République tchèque,CZE,2016,20,1964,NA,1981,-17,-0.9
République tchèque,CZE,2016,21,2000,NA,1985,15,0.8
République tchèque,CZE,2016,22,2042,NA,2041,1,0
République tchèque,CZE,2016,23,1893,NA,1947,-54,-2.8
République tchèque,CZE,2016,24,1915,NA,1975,-60,-3
République tchèque,CZE,2016,25,1993,NA,1995,-2,-0.1
République tchèque,CZE,2016,26,1970,NA,1979,-9,-0.5
République tchèque,CZE,2016,27,1886,NA,1966,-80,-4.1
République tchèque,CZE,2016,28,1918,NA,1950,-32,-1.6
République tchèque,CZE,2016,29,1981,NA,2006,-25,-1.2
République tchèque,CZE,2016,30,1942,NA,2009,-67,-3.3
République tchèque,CZE,2016,31,1827,NA,2073,-246,-11.9
République tchèque,CZE,2016,32,1839,NA,1986,-147,-7.4
République tchèque,CZE,2016,33,1949,NA,1940,9,0.5
République tchèque,CZE,2016,34,2043,NA,1999,44,2.2
République tchèque,CZE,2016,35,1918,NA,1955,-37,-1.9
République tchèque,CZE,2016,36,1980,NA,1950,30,1.5
République tchèque,CZE,2016,37,1930,NA,1970,-40,-2
République tchèque,CZE,2016,38,1834,NA,1994,-160,-8
République tchèque,CZE,2016,39,1988,NA,2044,-56,-2.7
République tchèque,CZE,2016,40,1991,NA,2126,-135,-6.3
République tchèque,CZE,2016,41,2083,NA,2128,-45,-2.1
République tchèque,CZE,2016,42,2142,NA,2071,71,3.4
République tchèque,CZE,2016,43,2035,NA,2075,-40,-1.9
République tchèque,CZE,2016,44,1997,NA,2066,-69,-3.3
République tchèque,CZE,2016,45,1968,NA,2041,-73,-3.6
République tchèque,CZE,2016,46,2134,NA,2103,31,1.5
République tchèque,CZE,2016,47,2084,NA,2117,-33,-1.6
République tchèque,CZE,2016,48,2125,NA,2118,7,0.3
République tchèque,CZE,2016,49,2200,NA,2144,56,2.6
République tchèque,CZE,2016,50,2204,NA,2188,16,0.7
République tchèque,CZE,2016,51,2435,NA,2276,159,7
République tchèque,CZE,2016,52,2620,NA,2303,317,13.8
République tchèque,CZE,2017,1,2763,NA,2362,401,17
République tchèque,CZE,2017,2,2811,NA,2320,491,21.2
République tchèque,CZE,2017,3,2833,NA,2387,446,18.7
République tchèque,CZE,2017,4,2761,NA,2358,403,17.1
République tchèque,CZE,2017,5,2598,NA,2362,236,10
République tchèque,CZE,2017,6,2640,NA,2434,206,8.5
République tchèque,CZE,2017,7,2492,NA,2441,51,2.1
République tchèque,CZE,2017,8,2357,NA,2455,-98,-4
République tchèque,CZE,2017,9,2353,NA,2430,-77,-3.2
République tchèque,CZE,2017,10,2225,NA,2424,-199,-8.2
République tchèque,CZE,2017,11,2164,NA,2341,-177,-7.6
République tchèque,CZE,2017,12,2103,NA,2264,-161,-7.1
République tchèque,CZE,2017,13,2075,NA,2193,-118,-5.4
République tchèque,CZE,2017,14,2069,NA,2150,-81,-3.8
République tchèque,CZE,2017,15,1994,NA,2118,-124,-5.9
République tchèque,CZE,2017,16,2043,NA,2037,6,0.3
République tchèque,CZE,2017,17,2051,NA,2090,-39,-1.9
République tchèque,CZE,2017,18,2041,NA,2024,17,0.8
République tchèque,CZE,2017,19,2074,NA,2032,42,2.1
République tchèque,CZE,2017,20,1974,NA,1981,-7,-0.4
République tchèque,CZE,2017,21,1932,NA,1985,-53,-2.7
République tchèque,CZE,2017,22,2033,NA,2041,-8,-0.4
République tchèque,CZE,2017,23,1836,NA,1947,-111,-5.7
République tchèque,CZE,2017,24,1978,NA,1975,3,0.2
République tchèque,CZE,2017,25,2042,NA,1995,47,2.4
République tchèque,CZE,2017,26,1939,NA,1979,-40,-2
République tchèque,CZE,2017,27,1953,NA,1966,-13,-0.7
République tchèque,CZE,2017,28,1886,NA,1950,-64,-3.3
République tchèque,CZE,2017,29,1972,NA,2006,-34,-1.7
République tchèque,CZE,2017,30,1770,NA,2009,-239,-11.9
République tchèque,CZE,2017,31,2077,NA,2073,4,0.2
République tchèque,CZE,2017,32,1959,NA,1986,-27,-1.4
République tchèque,CZE,2017,33,1861,NA,1940,-79,-4.1
République tchèque,CZE,2017,34,1939,NA,1999,-60,-3
République tchèque,CZE,2017,35,1848,NA,1955,-107,-5.5
République tchèque,CZE,2017,36,1920,NA,1950,-30,-1.5
République tchèque,CZE,2017,37,1991,NA,1970,21,1.1
République tchèque,CZE,2017,38,2058,NA,1994,64,3.2
République tchèque,CZE,2017,39,2125,NA,2044,81,4
République tchèque,CZE,2017,40,2235,NA,2126,109,5.1
République tchèque,CZE,2017,41,2156,NA,2128,28,1.3
République tchèque,CZE,2017,42,2029,NA,2071,-42,-2
République tchèque,CZE,2017,43,2101,NA,2075,26,1.3
République tchèque,CZE,2017,44,2053,NA,2066,-13,-0.6
République tchèque,CZE,2017,45,2040,NA,2041,-1,-0
République tchèque,CZE,2017,46,2057,NA,2103,-46,-2.2
République tchèque,CZE,2017,47,2071,NA,2117,-46,-2.2
République tchèque,CZE,2017,48,2116,NA,2118,-2,-0.1
République tchèque,CZE,2017,49,2102,NA,2144,-42,-2
République tchèque,CZE,2017,50,2187,NA,2188,-1,-0
République tchèque,CZE,2017,51,2119,NA,2276,-157,-6.9
République tchèque,CZE,2017,52,2201,NA,2303,-102,-4.4
République tchèque,CZE,2018,1,2143,NA,2362,-219,-9.3
République tchèque,CZE,2018,2,2126,NA,2320,-194,-8.4
République tchèque,CZE,2018,3,2230,NA,2387,-157,-6.6
République tchèque,CZE,2018,4,2190,NA,2358,-168,-7.1
République tchèque,CZE,2018,5,2216,NA,2362,-146,-6.2
République tchèque,CZE,2018,6,2404,NA,2434,-30,-1.2
République tchèque,CZE,2018,7,2602,NA,2441,161,6.6
République tchèque,CZE,2018,8,2754,NA,2455,299,12.2
République tchèque,CZE,2018,9,2819,NA,2430,389,16
République tchèque,CZE,2018,10,2994,NA,2424,570,23.5
République tchèque,CZE,2018,11,2782,NA,2341,441,18.8
République tchèque,CZE,2018,12,2607,NA,2264,343,15.2
République tchèque,CZE,2018,13,2383,NA,2193,190,8.7
République tchèque,CZE,2018,14,2262,NA,2150,112,5.2
République tchèque,CZE,2018,15,2257,NA,2118,139,6.6
République tchèque,CZE,2018,16,2061,NA,2037,24,1.2
République tchèque,CZE,2018,17,2090,NA,2090,0,0
République tchèque,CZE,2018,18,2022,NA,2024,-2,-0.1
République tchèque,CZE,2018,19,1958,NA,2032,-74,-3.6
République tchèque,CZE,2018,20,1962,NA,1981,-19,-1
République tchèque,CZE,2018,21,2013,NA,1985,28,1.4
République tchèque,CZE,2018,22,1995,NA,2041,-46,-2.3
République tchèque,CZE,2018,23,2038,NA,1947,91,4.7
République tchèque,CZE,2018,24,1863,NA,1975,-112,-5.7
République tchèque,CZE,2018,25,1964,NA,1995,-31,-1.6
République tchèque,CZE,2018,26,1940,NA,1979,-39,-2
République tchèque,CZE,2018,27,1979,NA,1966,13,0.7
République tchèque,CZE,2018,28,2041,NA,1950,91,4.7
République tchèque,CZE,2018,29,2039,NA,2006,33,1.6
République tchèque,CZE,2018,30,2153,NA,2009,144,7.2
République tchèque,CZE,2018,31,2379,NA,2073,306,14.8
République tchèque,CZE,2018,32,2118,NA,1986,132,6.6
République tchèque,CZE,2018,33,1923,NA,1940,-17,-0.9
République tchèque,CZE,2018,34,2004,NA,1999,5,0.3
République tchèque,CZE,2018,35,1902,NA,1955,-53,-2.7
République tchèque,CZE,2018,36,1979,NA,1950,29,1.5
République tchèque,CZE,2018,37,2014,NA,1970,44,2.2
République tchèque,CZE,2018,38,2056,NA,1994,62,3.1
République tchèque,CZE,2018,39,1906,NA,2044,-138,-6.8
République tchèque,CZE,2018,40,2123,NA,2126,-3,-0.1
République tchèque,CZE,2018,41,2076,NA,2128,-52,-2.4
République tchèque,CZE,2018,42,2014,NA,2071,-57,-2.8
République tchèque,CZE,2018,43,2024,NA,2075,-51,-2.5
République tchèque,CZE,2018,44,2148,NA,2066,82,4
République tchèque,CZE,2018,45,2046,NA,2041,5,0.2
République tchèque,CZE,2018,46,1991,NA,2103,-112,-5.3
République tchèque,CZE,2018,47,2141,NA,2117,24,1.1
République tchèque,CZE,2018,48,2095,NA,2118,-23,-1.1
République tchèque,CZE,2018,49,2194,NA,2144,50,2.3
République tchèque,CZE,2018,50,2136,NA,2188,-52,-2.4
République tchèque,CZE,2018,51,2303,NA,2276,27,1.2
République tchèque,CZE,2018,52,2145,NA,2303,-158,-6.9
République tchèque,CZE,2019,1,2321,NA,2362,-41,-1.7
République tchèque,CZE,2019,2,2290,NA,2320,-30,-1.3
République tchèque,CZE,2019,3,2311,NA,2387,-76,-3.2
République tchèque,CZE,2019,4,2365,NA,2358,7,0.3
République tchèque,CZE,2019,5,2497,NA,2362,135,5.7
République tchèque,CZE,2019,6,2445,NA,2434,11,0.5
République tchèque,CZE,2019,7,2509,NA,2441,68,2.8
République tchèque,CZE,2019,8,2496,NA,2455,41,1.7
République tchèque,CZE,2019,9,2313,NA,2430,-117,-4.8
République tchèque,CZE,2019,10,2383,NA,2424,-41,-1.7
République tchèque,CZE,2019,11,2262,NA,2341,-79,-3.4
République tchèque,CZE,2019,12,2198,NA,2264,-66,-2.9
République tchèque,CZE,2019,13,2124,NA,2193,-69,-3.1
République tchèque,CZE,2019,14,2131,NA,2150,-19,-0.9
République tchèque,CZE,2019,15,2145,NA,2118,27,1.3
République tchèque,CZE,2019,16,2094,NA,2037,57,2.8
République tchèque,CZE,2019,17,2103,NA,2090,13,0.6
République tchèque,CZE,2019,18,2051,NA,2024,27,1.3
République tchèque,CZE,2019,19,2093,NA,2032,61,3
République tchèque,CZE,2019,20,2025,NA,1981,44,2.2
République tchèque,CZE,2019,21,1995,NA,1985,10,0.5
République tchèque,CZE,2019,22,2093,NA,2041,52,2.5
République tchèque,CZE,2019,23,2020,NA,1947,73,3.7
République tchèque,CZE,2019,24,2145,NA,1975,170,8.6
République tchèque,CZE,2019,25,1980,NA,1995,-15,-0.8
République tchèque,CZE,2019,26,2067,NA,1979,88,4.4
République tchèque,CZE,2019,27,2046,NA,1966,80,4.1
République tchèque,CZE,2019,28,1956,NA,1950,6,0.3
République tchèque,CZE,2019,29,2034,NA,2006,28,1.4
République tchèque,CZE,2019,30,2171,NA,2009,162,8.1
République tchèque,CZE,2019,31,2010,NA,2073,-63,-3
République tchèque,CZE,2019,32,2027,NA,1986,41,2.1
République tchèque,CZE,2019,33,2026,NA,1940,86,4.4
République tchèque,CZE,2019,34,2011,NA,1999,12,0.6
République tchèque,CZE,2019,35,2151,NA,1955,196,10
République tchèque,CZE,2019,36,1922,NA,1950,-28,-1.4
République tchèque,CZE,2019,37,1944,NA,1970,-26,-1.3
République tchèque,CZE,2019,38,2030,NA,1994,36,1.8
République tchèque,CZE,2019,39,2157,NA,2044,113,5.5
République tchèque,CZE,2019,40,2153,NA,2126,27,1.3
République tchèque,CZE,2019,41,2197,NA,2128,69,3.2
République tchèque,CZE,2019,42,2099,NA,2071,28,1.4
République tchèque,CZE,2019,43,2139,NA,2075,64,3.1
République tchèque,CZE,2019,44,2066,NA,2066,0,0
République tchèque,CZE,2019,45,2110,NA,2041,69,3.4
République tchèque,CZE,2019,46,2231,NA,2103,128,6.1
République tchèque,CZE,2019,47,2173,NA,2117,56,2.6
République tchèque,CZE,2019,48,2134,NA,2118,16,0.8
République tchèque,CZE,2019,49,2078,NA,2144,-66,-3.1
République tchèque,CZE,2019,50,2226,NA,2188,38,1.7
République tchèque,CZE,2019,51,2248,NA,2276,-28,-1.2
République tchèque,CZE,2019,52,2245,NA,2303,-58,-2.5
République tchèque,CZE,2020,1,2298,0,2362,-64,-2.7
République tchèque,CZE,2020,2,2306,0,2320,-14,-0.6
République tchèque,CZE,2020,3,2237,0,2387,-150,-6.3
République tchèque,CZE,2020,4,2325,0,2358,-33,-1.4
République tchèque,CZE,2020,5,2356,0,2362,-6,-0.3
République tchèque,CZE,2020,6,2346,0,2434,-88,-3.6
République tchèque,CZE,2020,7,2381,0,2441,-60,-2.5
République tchèque,CZE,2020,8,2335,0,2455,-120,-4.9
République tchèque,CZE,2020,9,2346,0,2430,-84,-3.5
République tchèque,CZE,2020,10,2280,0,2424,-144,-5.9
République tchèque,CZE,2020,11,2288,0,2341,-53,-2.3
République tchèque,CZE,2020,12,2314,1,2264,50,2.2
République tchèque,CZE,2020,13,2278,23,2193,85,3.9
République tchèque,CZE,2020,14,2302,54,2150,152,7.1
République tchèque,CZE,2020,15,2222,65,2118,104,4.9
République tchèque,CZE,2020,16,2101,53,2037,64,3.1
République tchèque,CZE,2020,17,2015,27,2090,-75,-3.6
République tchèque,CZE,2020,18,2071,29,2024,47,2.3
Allemagne,DEU,2016,1,18467,NA,19339,-872,-4.5
Allemagne,DEU,2016,2,18439,NA,19593,-1154,-5.9
Allemagne,DEU,2016,3,18627,NA,19524,-897,-4.6
Allemagne,DEU,2016,4,18707,NA,19855,-1148,-5.8
Allemagne,DEU,2016,5,18493,NA,20366,-1873,-9.2
Allemagne,DEU,2016,6,18541,NA,20319,-1778,-8.8
Allemagne,DEU,2016,7,18483,NA,20636,-2153,-10.4
Allemagne,DEU,2016,8,18475,NA,20988,-2513,-12
Allemagne,DEU,2016,9,18927,NA,21532,-2605,-12.1
Allemagne,DEU,2016,10,18888,NA,21288,-2400,-11.3
Allemagne,DEU,2016,11,18971,NA,20440,-1469,-7.2
Allemagne,DEU,2016,12,18826,NA,19555,-729,-3.7
Allemagne,DEU,2016,13,18617,NA,18939,-322,-1.7
Allemagne,DEU,2016,14,18245,NA,18480,-235,-1.3
Allemagne,DEU,2016,15,17712,NA,17893,-181,-1
Allemagne,DEU,2016,16,16775,NA,17357,-582,-3.4
Allemagne,DEU,2016,17,17053,NA,17407,-354,-2
Allemagne,DEU,2016,18,16901,NA,16961,-60,-0.4
Allemagne,DEU,2016,19,17629,NA,17314,315,1.8
Allemagne,DEU,2016,20,16601,NA,16852,-251,-1.5
Allemagne,DEU,2016,21,16286,NA,16580,-294,-1.8
Allemagne,DEU,2016,22,16346,NA,16790,-444,-2.6
Allemagne,DEU,2016,23,15799,NA,16446,-647,-3.9
Allemagne,DEU,2016,24,15717,NA,15947,-230,-1.4
Allemagne,DEU,2016,25,16910,NA,16538,372,2.2
Allemagne,DEU,2016,26,15699,NA,16550,-851,-5.1
Allemagne,DEU,2016,27,16229,NA,16441,-212,-1.3
Allemagne,DEU,2016,28,16172,NA,16026,146,0.9
Allemagne,DEU,2016,29,16985,NA,16764,221,1.3
Allemagne,DEU,2016,30,16157,NA,17542,-1385,-7.9
Allemagne,DEU,2016,31,15439,NA,17320,-1881,-10.9
Allemagne,DEU,2016,32,15487,NA,16562,-1075,-6.5
Allemagne,DEU,2016,33,16258,NA,16304,-46,-0.3
Allemagne,DEU,2016,34,17147,NA,16461,686,4.2
Allemagne,DEU,2016,35,16101,NA,16442,-341,-2.1
Allemagne,DEU,2016,36,16116,NA,16040,76,0.5
Allemagne,DEU,2016,37,16372,NA,16262,110,0.7
Allemagne,DEU,2016,38,15606,NA,16306,-700,-4.3
Allemagne,DEU,2016,39,16336,NA,16603,-267,-1.6
Allemagne,DEU,2016,40,16352,NA,16625,-273,-1.6
Allemagne,DEU,2016,41,17427,NA,17376,51,0.3
Allemagne,DEU,2016,42,17599,NA,17229,370,2.1
Allemagne,DEU,2016,43,17586,NA,17120,466,2.7
Allemagne,DEU,2016,44,17580,NA,17143,437,2.5
Allemagne,DEU,2016,45,17782,NA,17616,166,0.9
Allemagne,DEU,2016,46,18591,NA,17780,811,4.6
Allemagne,DEU,2016,47,17911,NA,17954,-43,-0.2
Allemagne,DEU,2016,48,18147,NA,18171,-24,-0.1
Allemagne,DEU,2016,49,18793,NA,18678,115,0.6
Allemagne,DEU,2016,50,18885,NA,18606,279,1.5
Allemagne,DEU,2016,51,19376,NA,18978,398,2.1
Allemagne,DEU,2016,52,19744,NA,18621,1123,6
Allemagne,DEU,2017,1,20918,NA,19339,1579,8.2
Allemagne,DEU,2017,2,22070,NA,19593,2477,12.6
Allemagne,DEU,2017,3,21236,NA,19524,1712,8.8
Allemagne,DEU,2017,4,22083,NA,19855,2228,11.2
Allemagne,DEU,2017,5,23640,NA,20366,3274,16.1
Allemagne,DEU,2017,6,22745,NA,20319,2426,11.9
Allemagne,DEU,2017,7,22683,NA,20636,2047,9.9
Allemagne,DEU,2017,8,22267,NA,20988,1279,6.1
Allemagne,DEU,2017,9,20930,NA,21532,-602,-2.8
Allemagne,DEU,2017,10,19102,NA,21288,-2186,-10.3
Allemagne,DEU,2017,11,18665,NA,20440,-1775,-8.7
Allemagne,DEU,2017,12,17640,NA,19555,-1915,-9.8
Allemagne,DEU,2017,13,17731,NA,18939,-1208,-6.4
Allemagne,DEU,2017,14,17028,NA,18480,-1452,-7.9
Allemagne,DEU,2017,15,16901,NA,17893,-992,-5.5
Allemagne,DEU,2017,16,16637,NA,17357,-720,-4.1
Allemagne,DEU,2017,17,17634,NA,17407,227,1.3
Allemagne,DEU,2017,18,17129,NA,16961,168,1
Allemagne,DEU,2017,19,17343,NA,17314,29,0.2
Allemagne,DEU,2017,20,17079,NA,16852,227,1.3
Allemagne,DEU,2017,21,16451,NA,16580,-129,-0.8
Allemagne,DEU,2017,22,16902,NA,16790,112,0.7
Allemagne,DEU,2017,23,15846,NA,16446,-600,-3.6
Allemagne,DEU,2017,24,16087,NA,15947,140,0.9
Allemagne,DEU,2017,25,16819,NA,16538,281,1.7
Allemagne,DEU,2017,26,16076,NA,16550,-474,-2.9
Allemagne,DEU,2017,27,16424,NA,16441,-17,-0.1
Allemagne,DEU,2017,28,15603,NA,16026,-423,-2.6
Allemagne,DEU,2017,29,16589,NA,16764,-175,-1
Allemagne,DEU,2017,30,16058,NA,17542,-1484,-8.5
Allemagne,DEU,2017,31,16494,NA,17320,-826,-4.8
Allemagne,DEU,2017,32,15784,NA,16562,-778,-4.7
Allemagne,DEU,2017,33,16149,NA,16304,-155,-1
Allemagne,DEU,2017,34,15880,NA,16461,-581,-3.5
Allemagne,DEU,2017,35,16064,NA,16442,-378,-2.3
Allemagne,DEU,2017,36,15707,NA,16040,-333,-2.1
Allemagne,DEU,2017,37,16147,NA,16262,-115,-0.7
Allemagne,DEU,2017,38,16505,NA,16306,199,1.2
Allemagne,DEU,2017,39,16747,NA,16603,144,0.9
Allemagne,DEU,2017,40,16664,NA,16625,39,0.2
Allemagne,DEU,2017,41,17470,NA,17376,94,0.5
Allemagne,DEU,2017,42,17139,NA,17229,-90,-0.5
Allemagne,DEU,2017,43,17059,NA,17120,-61,-0.4
Allemagne,DEU,2017,44,16762,NA,17143,-381,-2.2
Allemagne,DEU,2017,45,17371,NA,17616,-245,-1.4
Allemagne,DEU,2017,46,17595,NA,17780,-185,-1
Allemagne,DEU,2017,47,17677,NA,17954,-277,-1.5
Allemagne,DEU,2017,48,17877,NA,18171,-294,-1.6
Allemagne,DEU,2017,49,18295,NA,18678,-383,-2.1
Allemagne,DEU,2017,50,18504,NA,18606,-102,-0.5
Allemagne,DEU,2017,51,18502,NA,18978,-476,-2.5
Allemagne,DEU,2017,52,18652,NA,18621,31,0.2
Allemagne,DEU,2018,1,19342,NA,19339,3,0
Allemagne,DEU,2018,2,18770,NA,19593,-823,-4.2
Allemagne,DEU,2018,3,19187,NA,19524,-337,-1.7
Allemagne,DEU,2018,4,19171,NA,19855,-684,-3.4
Allemagne,DEU,2018,5,19558,NA,20366,-808,-4
Allemagne,DEU,2018,6,20086,NA,20319,-233,-1.1
Allemagne,DEU,2018,7,21254,NA,20636,618,3
Allemagne,DEU,2018,8,22888,NA,20988,1900,9.1
Allemagne,DEU,2018,9,25535,NA,21532,4003,18.6
Allemagne,DEU,2018,10,26777,NA,21288,5489,25.8
Allemagne,DEU,2018,11,24385,NA,20440,3945,19.3
Allemagne,DEU,2018,12,22777,NA,19555,3222,16.5
Allemagne,DEU,2018,13,20906,NA,18939,1967,10.4
Allemagne,DEU,2018,14,20038,NA,18480,1558,8.4
Allemagne,DEU,2018,15,19165,NA,17893,1272,7.1
Allemagne,DEU,2018,16,17992,NA,17357,635,3.7
Allemagne,DEU,2018,17,17093,NA,17407,-314,-1.8
Allemagne,DEU,2018,18,16789,NA,16961,-172,-1
Allemagne,DEU,2018,19,17226,NA,17314,-88,-0.5
Allemagne,DEU,2018,20,16488,NA,16852,-364,-2.2
Allemagne,DEU,2018,21,16513,NA,16580,-67,-0.4
Allemagne,DEU,2018,22,17039,NA,16790,249,1.5
Allemagne,DEU,2018,23,16714,NA,16446,268,1.6
Allemagne,DEU,2018,24,15582,NA,15947,-365,-2.3
Allemagne,DEU,2018,25,15843,NA,16538,-695,-4.2
Allemagne,DEU,2018,26,16569,NA,16550,19,0.1
Allemagne,DEU,2018,27,16622,NA,16441,181,1.1
Allemagne,DEU,2018,28,16070,NA,16026,44,0.3
Allemagne,DEU,2018,29,16702,NA,16764,-62,-0.4
Allemagne,DEU,2018,30,18340,NA,17542,798,4.5
Allemagne,DEU,2018,31,20371,NA,17320,3051,17.6
Allemagne,DEU,2018,32,18478,NA,16562,1916,11.6
Allemagne,DEU,2018,33,16890,NA,16304,586,3.6
Allemagne,DEU,2018,34,16612,NA,16461,151,0.9
Allemagne,DEU,2018,35,16000,NA,16442,-442,-2.7
Allemagne,DEU,2018,36,16390,NA,16040,350,2.2
Allemagne,DEU,2018,37,16292,NA,16262,30,0.2
Allemagne,DEU,2018,38,16651,NA,16306,345,2.1
Allemagne,DEU,2018,39,15969,NA,16603,-634,-3.8
Allemagne,DEU,2018,40,16622,NA,16625,-3,-0
Allemagne,DEU,2018,41,16993,NA,17376,-383,-2.2
Allemagne,DEU,2018,42,16552,NA,17229,-677,-3.9
Allemagne,DEU,2018,43,16608,NA,17120,-512,-3
Allemagne,DEU,2018,44,16895,NA,17143,-248,-1.4
Allemagne,DEU,2018,45,17604,NA,17616,-12,-0.1
Allemagne,DEU,2018,46,16842,NA,17780,-938,-5.3
Allemagne,DEU,2018,47,17785,NA,17954,-169,-0.9
Allemagne,DEU,2018,48,18091,NA,18171,-80,-0.4
Allemagne,DEU,2018,49,18342,NA,18678,-336,-1.8
Allemagne,DEU,2018,50,17943,NA,18606,-663,-3.6
Allemagne,DEU,2018,51,18990,NA,18978,12,0.1
Allemagne,DEU,2018,52,17954,NA,18621,-667,-3.6
Allemagne,DEU,2019,1,18628,NA,19339,-711,-3.7
Allemagne,DEU,2019,2,19092,NA,19593,-501,-2.6
Allemagne,DEU,2019,3,19046,NA,19524,-478,-2.4
Allemagne,DEU,2019,4,19458,NA,19855,-397,-2
Allemagne,DEU,2019,5,19774,NA,20366,-592,-2.9
Allemagne,DEU,2019,6,19905,NA,20319,-414,-2
Allemagne,DEU,2019,7,20125,NA,20636,-511,-2.5
Allemagne,DEU,2019,8,20321,NA,20988,-667,-3.2
Allemagne,DEU,2019,9,20737,NA,21532,-795,-3.7
Allemagne,DEU,2019,10,20386,NA,21288,-902,-4.2
Allemagne,DEU,2019,11,19738,NA,20440,-702,-3.4
Allemagne,DEU,2019,12,18976,NA,19555,-579,-3
Allemagne,DEU,2019,13,18501,NA,18939,-438,-2.3
Allemagne,DEU,2019,14,18608,NA,18480,128,0.7
Allemagne,DEU,2019,15,17794,NA,17893,-99,-0.6
Allemagne,DEU,2019,16,18025,NA,17357,668,3.8
Allemagne,DEU,2019,17,17849,NA,17407,442,2.5
Allemagne,DEU,2019,18,17024,NA,16961,63,0.4
Allemagne,DEU,2019,19,17059,NA,17314,-255,-1.5
Allemagne,DEU,2019,20,17239,NA,16852,387,2.3
Allemagne,DEU,2019,21,17068,NA,16580,488,2.9
Allemagne,DEU,2019,22,16873,NA,16790,83,0.5
Allemagne,DEU,2019,23,17426,NA,16446,980,6
Allemagne,DEU,2019,24,16403,NA,15947,456,2.9
Allemagne,DEU,2019,25,16581,NA,16538,43,0.3
Allemagne,DEU,2019,26,17854,NA,16550,1304,7.9
Allemagne,DEU,2019,27,16489,NA,16441,48,0.3
Allemagne,DEU,2019,28,16260,NA,16026,234,1.5
Allemagne,DEU,2019,29,16779,NA,16764,15,0.1
Allemagne,DEU,2019,30,19614,NA,17542,2072,11.8
Allemagne,DEU,2019,31,16974,NA,17320,-346,-2
Allemagne,DEU,2019,32,16501,NA,16562,-61,-0.4
Allemagne,DEU,2019,33,15918,NA,16304,-386,-2.4
Allemagne,DEU,2019,34,16205,NA,16461,-256,-1.6
Allemagne,DEU,2019,35,17601,NA,16442,1159,7
Allemagne,DEU,2019,36,15949,NA,16040,-91,-0.6
Allemagne,DEU,2019,37,16235,NA,16262,-27,-0.2
Allemagne,DEU,2019,38,16460,NA,16306,154,0.9
Allemagne,DEU,2019,39,17361,NA,16603,758,4.6
Allemagne,DEU,2019,40,16862,NA,16625,237,1.4
Allemagne,DEU,2019,41,17615,NA,17376,239,1.4
Allemagne,DEU,2019,42,17626,NA,17229,397,2.3
Allemagne,DEU,2019,43,17229,NA,17120,109,0.6
Allemagne,DEU,2019,44,17334,NA,17143,191,1.1
Allemagne,DEU,2019,45,17708,NA,17616,92,0.5
Allemagne,DEU,2019,46,18093,NA,17780,313,1.8
Allemagne,DEU,2019,47,18445,NA,17954,491,2.7
Allemagne,DEU,2019,48,18569,NA,18171,398,2.2
Allemagne,DEU,2019,49,19280,NA,18678,602,3.2
Allemagne,DEU,2019,50,19092,NA,18606,486,2.6
Allemagne,DEU,2019,51,19046,NA,18978,68,0.4
Allemagne,DEU,2019,52,18135,NA,18621,-486,-2.6
Allemagne,DEU,2020,1,18853,0,19339,-486,-2.5
Allemagne,DEU,2020,2,19406,0,19593,-187,-1
Allemagne,DEU,2020,3,19139,0,19524,-385,-2
Allemagne,DEU,2020,4,18917,0,19855,-938,-4.7
Allemagne,DEU,2020,5,19742,0,20366,-624,-3.1
Allemagne,DEU,2020,6,18964,0,20319,-1355,-6.7
Allemagne,DEU,2020,7,19561,0,20636,-1075,-5.2
Allemagne,DEU,2020,8,18884,0,20988,-2104,-10
Allemagne,DEU,2020,9,19399,0,21532,-2133,-9.9
Allemagne,DEU,2020,10,19556,2,21288,-1732,-8.1
Allemagne,DEU,2020,11,19761,11,20440,-679,-3.3
Allemagne,DEU,2020,12,19602,113,19555,47,0.2
Allemagne,DEU,2020,13,19598,457,18939,659,3.5
Allemagne,DEU,2020,14,20507,1024,18480,2027,11
Allemagne,DEU,2020,15,20333,1362,17893,2440,13.6
Allemagne,DEU,2020,16,19095,1629,17357,1738,10
Allemagne,DEU,2020,17,18341,1315,17407,934,5.4
Allemagne,DEU,2020,18,17669,918,16961,708,4.2
Allemagne,DEU,2020,19,17314,702,17314,0,0
Allemagne,DEU,2020,20,16579,474,16852,-273,-1.6
Allemagne,DEU,2020,21,16600,295,16580,20,0.1
Danemark,DNK,2016,1,1103,NA,1120,-17,-1.5
Danemark,DNK,2016,2,1065,NA,1117,-52,-4.7
Danemark,DNK,2016,3,1046,NA,1105,-59,-5.3
Danemark,DNK,2016,4,1124,NA,1108,16,1.4
Danemark,DNK,2016,5,1083,NA,1165,-82,-7
Danemark,DNK,2016,6,1040,NA,1144,-104,-9.1
Danemark,DNK,2016,7,1062,NA,1183,-121,-10.2
Danemark,DNK,2016,8,1124,NA,1162,-38,-3.3
Danemark,DNK,2016,9,1143,NA,1184,-41,-3.5
Danemark,DNK,2016,10,1149,NA,1160,-11,-0.9
Danemark,DNK,2016,11,1159,NA,1152,7,0.6
Danemark,DNK,2016,12,1074,NA,1131,-57,-5
Danemark,DNK,2016,13,1084,NA,1083,1,0.1
Danemark,DNK,2016,14,1023,NA,1058,-35,-3.3
Danemark,DNK,2016,15,1071,NA,1066,5,0.5
Danemark,DNK,2016,16,1010,NA,1019,-9,-0.9
Danemark,DNK,2016,17,985,NA,996,-11,-1.1
Danemark,DNK,2016,18,1042,NA,1044,-2,-0.2
Danemark,DNK,2016,19,1023,NA,1023,0,0
Danemark,DNK,2016,20,935,NA,986,-51,-5.2
Danemark,DNK,2016,21,975,NA,967,8,0.8
Danemark,DNK,2016,22,953,NA,967,-14,-1.4
Danemark,DNK,2016,23,913,NA,974,-61,-6.3
Danemark,DNK,2016,24,920,NA,963,-43,-4.5
Danemark,DNK,2016,25,983,NA,984,-1,-0.1
Danemark,DNK,2016,26,897,NA,938,-41,-4.4
Danemark,DNK,2016,27,924,NA,943,-19,-2
Danemark,DNK,2016,28,898,NA,941,-43,-4.6
Danemark,DNK,2016,29,971,NA,968,3,0.3
Danemark,DNK,2016,30,962,NA,986,-24,-2.4
Danemark,DNK,2016,31,902,NA,970,-68,-7
Danemark,DNK,2016,32,956,NA,963,-7,-0.7
Danemark,DNK,2016,33,914,NA,942,-28,-3
Danemark,DNK,2016,34,971,NA,980,-9,-0.9
Danemark,DNK,2016,35,922,NA,951,-29,-3
Danemark,DNK,2016,36,955,NA,958,-3,-0.3
Danemark,DNK,2016,37,932,NA,960,-28,-2.9
Danemark,DNK,2016,38,904,NA,971,-67,-6.9
Danemark,DNK,2016,39,983,NA,983,0,0
Danemark,DNK,2016,40,910,NA,973,-63,-6.5
Danemark,DNK,2016,41,1022,NA,1008,14,1.4
Danemark,DNK,2016,42,1040,NA,992,48,4.8
Danemark,DNK,2016,43,989,NA,980,9,0.9
Danemark,DNK,2016,44,1003,NA,985,18,1.8
Danemark,DNK,2016,45,1017,NA,1003,14,1.4
Danemark,DNK,2016,46,1045,NA,1026,19,1.9
Danemark,DNK,2016,47,1046,NA,1028,18,1.8
Danemark,DNK,2016,48,1010,NA,1032,-22,-2.1
Danemark,DNK,2016,49,1043,NA,1075,-32,-3
Danemark,DNK,2016,50,1067,NA,1080,-13,-1.2
Danemark,DNK,2016,51,1060,NA,1064,-4,-0.4
Danemark,DNK,2016,52,1149,NA,1082,67,6.2
Danemark,DNK,2017,1,1113,NA,1120,-7,-0.6
Danemark,DNK,2017,2,1111,NA,1117,-6,-0.5
Danemark,DNK,2017,3,1099,NA,1105,-6,-0.5
Danemark,DNK,2017,4,1104,NA,1108,-4,-0.4
Danemark,DNK,2017,5,1211,NA,1165,46,3.9
Danemark,DNK,2017,6,1100,NA,1144,-44,-3.8
Danemark,DNK,2017,7,1228,NA,1183,45,3.8
Danemark,DNK,2017,8,1156,NA,1162,-6,-0.5
Danemark,DNK,2017,9,1179,NA,1184,-5,-0.4
Danemark,DNK,2017,10,1101,NA,1160,-59,-5.1
Danemark,DNK,2017,11,1132,NA,1152,-20,-1.7
Danemark,DNK,2017,12,1126,NA,1131,-5,-0.4
Danemark,DNK,2017,13,1041,NA,1083,-42,-3.9
Danemark,DNK,2017,14,988,NA,1058,-70,-6.6
Danemark,DNK,2017,15,1009,NA,1066,-57,-5.3
Danemark,DNK,2017,16,967,NA,1019,-52,-5.1
Danemark,DNK,2017,17,974,NA,996,-22,-2.2
Danemark,DNK,2017,18,1059,NA,1044,15,1.4
Danemark,DNK,2017,19,1015,NA,1023,-8,-0.8
Danemark,DNK,2017,20,1022,NA,986,36,3.7
Danemark,DNK,2017,21,969,NA,967,2,0.2
Danemark,DNK,2017,22,956,NA,967,-11,-1.1
Danemark,DNK,2017,23,985,NA,974,11,1.1
Danemark,DNK,2017,24,1023,NA,963,60,6.2
Danemark,DNK,2017,25,980,NA,984,-4,-0.4
Danemark,DNK,2017,26,938,NA,938,0,0
Danemark,DNK,2017,27,905,NA,943,-38,-4
Danemark,DNK,2017,28,941,NA,941,0,0
Danemark,DNK,2017,29,931,NA,968,-37,-3.8
Danemark,DNK,2017,30,925,NA,986,-61,-6.2
Danemark,DNK,2017,31,934,NA,970,-36,-3.7
Danemark,DNK,2017,32,932,NA,963,-31,-3.2
Danemark,DNK,2017,33,906,NA,942,-36,-3.8
Danemark,DNK,2017,34,953,NA,980,-27,-2.8
Danemark,DNK,2017,35,951,NA,951,0,0
Danemark,DNK,2017,36,918,NA,958,-40,-4.2
Danemark,DNK,2017,37,991,NA,960,31,3.2
Danemark,DNK,2017,38,979,NA,971,8,0.8
Danemark,DNK,2017,39,983,NA,983,0,0
Danemark,DNK,2017,40,978,NA,973,5,0.5
Danemark,DNK,2017,41,985,NA,1008,-23,-2.3
Danemark,DNK,2017,42,970,NA,992,-22,-2.2
Danemark,DNK,2017,43,934,NA,980,-46,-4.7
Danemark,DNK,2017,44,976,NA,985,-9,-0.9
Danemark,DNK,2017,45,956,NA,1003,-47,-4.7
Danemark,DNK,2017,46,1070,NA,1026,44,4.3
Danemark,DNK,2017,47,1011,NA,1028,-17,-1.7
Danemark,DNK,2017,48,1027,NA,1032,-5,-0.5
Danemark,DNK,2017,49,1067,NA,1075,-8,-0.7
Danemark,DNK,2017,50,1102,NA,1080,22,2
Danemark,DNK,2017,51,1058,NA,1064,-6,-0.6
Danemark,DNK,2017,52,1134,NA,1082,52,4.8
Danemark,DNK,2018,1,1134,NA,1120,14,1.2
Danemark,DNK,2018,2,1136,NA,1117,19,1.7
Danemark,DNK,2018,3,1156,NA,1105,51,4.6
Danemark,DNK,2018,4,1119,NA,1108,11,1
Danemark,DNK,2018,5,1157,NA,1165,-8,-0.7
Danemark,DNK,2018,6,1186,NA,1144,42,3.7
Danemark,DNK,2018,7,1265,NA,1183,82,6.9
Danemark,DNK,2018,8,1260,NA,1162,98,8.4
Danemark,DNK,2018,9,1323,NA,1184,139,11.7
Danemark,DNK,2018,10,1337,NA,1160,177,15.3
Danemark,DNK,2018,11,1253,NA,1152,101,8.8
Danemark,DNK,2018,12,1286,NA,1131,155,13.7
Danemark,DNK,2018,13,1186,NA,1083,103,9.5
Danemark,DNK,2018,14,1138,NA,1058,80,7.6
Danemark,DNK,2018,15,1164,NA,1066,98,9.2
Danemark,DNK,2018,16,1052,NA,1019,33,3.2
Danemark,DNK,2018,17,1008,NA,996,12,1.2
Danemark,DNK,2018,18,1010,NA,1044,-34,-3.3
Danemark,DNK,2018,19,1025,NA,1023,2,0.2
Danemark,DNK,2018,20,1012,NA,986,26,2.6
Danemark,DNK,2018,21,953,NA,967,-14,-1.4
Danemark,DNK,2018,22,977,NA,967,10,1
Danemark,DNK,2018,23,1009,NA,974,35,3.6
Danemark,DNK,2018,24,941,NA,963,-22,-2.3
Danemark,DNK,2018,25,958,NA,984,-26,-2.6
Danemark,DNK,2018,26,915,NA,938,-23,-2.5
Danemark,DNK,2018,27,1007,NA,943,64,6.8
Danemark,DNK,2018,28,971,NA,941,30,3.2
Danemark,DNK,2018,29,994,NA,968,26,2.7
Danemark,DNK,2018,30,1091,NA,986,105,10.6
Danemark,DNK,2018,31,1084,NA,970,114,11.8
Danemark,DNK,2018,32,1029,NA,963,66,6.9
Danemark,DNK,2018,33,1017,NA,942,75,8
Danemark,DNK,2018,34,990,NA,980,10,1
Danemark,DNK,2018,35,935,NA,951,-16,-1.7
Danemark,DNK,2018,36,975,NA,958,17,1.8
Danemark,DNK,2018,37,949,NA,960,-11,-1.1
Danemark,DNK,2018,38,994,NA,971,23,2.4
Danemark,DNK,2018,39,950,NA,983,-33,-3.4
Danemark,DNK,2018,40,1033,NA,973,60,6.2
Danemark,DNK,2018,41,992,NA,1008,-16,-1.6
Danemark,DNK,2018,42,958,NA,992,-34,-3.4
Danemark,DNK,2018,43,973,NA,980,-7,-0.7
Danemark,DNK,2018,44,1007,NA,985,22,2.2
Danemark,DNK,2018,45,992,NA,1003,-11,-1.1
Danemark,DNK,2018,46,954,NA,1026,-72,-7
Danemark,DNK,2018,47,996,NA,1028,-32,-3.1
Danemark,DNK,2018,48,994,NA,1032,-38,-3.7
Danemark,DNK,2018,49,1085,NA,1075,10,0.9
Danemark,DNK,2018,50,1044,NA,1080,-36,-3.3
Danemark,DNK,2018,51,1096,NA,1064,32,3
Danemark,DNK,2018,52,1006,NA,1082,-76,-7
Danemark,DNK,2019,1,1130,NA,1120,10,0.9
Danemark,DNK,2019,2,1155,NA,1117,38,3.4
Danemark,DNK,2019,3,1118,NA,1105,13,1.2
Danemark,DNK,2019,4,1085,NA,1108,-23,-2.1
Danemark,DNK,2019,5,1209,NA,1165,44,3.8
Danemark,DNK,2019,6,1250,NA,1144,106,9.3
Danemark,DNK,2019,7,1176,NA,1183,-7,-0.6
Danemark,DNK,2019,8,1110,NA,1162,-52,-4.5
Danemark,DNK,2019,9,1090,NA,1184,-94,-7.9
Danemark,DNK,2019,10,1051,NA,1160,-109,-9.4
Danemark,DNK,2019,11,1063,NA,1152,-89,-7.7
Danemark,DNK,2019,12,1039,NA,1131,-92,-8.1
Danemark,DNK,2019,13,1022,NA,1083,-61,-5.6
Danemark,DNK,2019,14,1085,NA,1058,27,2.6
Danemark,DNK,2019,15,1018,NA,1066,-48,-4.5
Danemark,DNK,2019,16,1046,NA,1019,27,2.6
Danemark,DNK,2019,17,1015,NA,996,19,1.9
Danemark,DNK,2019,18,1067,NA,1044,23,2.2
Danemark,DNK,2019,19,1028,NA,1023,5,0.5
Danemark,DNK,2019,20,974,NA,986,-12,-1.2
Danemark,DNK,2019,21,970,NA,967,3,0.3
Danemark,DNK,2019,22,983,NA,967,16,1.7
Danemark,DNK,2019,23,991,NA,974,17,1.7
Danemark,DNK,2019,24,969,NA,963,6,0.6
Danemark,DNK,2019,25,1015,NA,984,31,3.2
Danemark,DNK,2019,26,1002,NA,938,64,6.8
Danemark,DNK,2019,27,935,NA,943,-8,-0.8
Danemark,DNK,2019,28,953,NA,941,12,1.3
Danemark,DNK,2019,29,977,NA,968,9,0.9
Danemark,DNK,2019,30,967,NA,986,-19,-1.9
Danemark,DNK,2019,31,962,NA,970,-8,-0.8
Danemark,DNK,2019,32,936,NA,963,-27,-2.8
Danemark,DNK,2019,33,931,NA,942,-11,-1.2
Danemark,DNK,2019,34,1006,NA,980,26,2.7
Danemark,DNK,2019,35,996,NA,951,45,4.7
Danemark,DNK,2019,36,983,NA,958,25,2.6
Danemark,DNK,2019,37,966,NA,960,6,0.6
Danemark,DNK,2019,38,1007,NA,971,36,3.7
Danemark,DNK,2019,39,1016,NA,983,33,3.4
Danemark,DNK,2019,40,972,NA,973,-1,-0.1
Danemark,DNK,2019,41,1033,NA,1008,25,2.5
Danemark,DNK,2019,42,998,NA,992,6,0.6
Danemark,DNK,2019,43,1026,NA,980,46,4.7
Danemark,DNK,2019,44,954,NA,985,-31,-3.1
Danemark,DNK,2019,45,1046,NA,1003,43,4.3
Danemark,DNK,2019,46,1037,NA,1026,11,1.1
Danemark,DNK,2019,47,1057,NA,1028,29,2.8
Danemark,DNK,2019,48,1095,NA,1032,63,6.1
Danemark,DNK,2019,49,1104,NA,1075,29,2.7
Danemark,DNK,2019,50,1107,NA,1080,27,2.5
Danemark,DNK,2019,51,1042,NA,1064,-22,-2.1
Danemark,DNK,2019,52,1038,NA,1082,-44,-4.1
Danemark,DNK,2020,1,1116,0,1120,-4,-0.4
Danemark,DNK,2020,2,1149,0,1117,32,2.9
Danemark,DNK,2020,3,1069,0,1105,-36,-3.3
Danemark,DNK,2020,4,1025,0,1108,-83,-7.5
Danemark,DNK,2020,5,1087,0,1165,-78,-6.7
Danemark,DNK,2020,6,1078,0,1144,-66,-5.8
Danemark,DNK,2020,7,1057,0,1183,-126,-10.7
Danemark,DNK,2020,8,1034,0,1162,-128,-11
Danemark,DNK,2020,9,1021,0,1184,-163,-13.8
Danemark,DNK,2020,10,1060,0,1160,-100,-8.6
Danemark,DNK,2020,11,1064,1,1152,-88,-7.6
Danemark,DNK,2020,12,1138,23,1131,7,0.6
Danemark,DNK,2020,13,1108,53,1083,25,2.3
Danemark,DNK,2020,14,1153,110,1058,95,9
Danemark,DNK,2020,15,1141,98,1066,75,7
Danemark,DNK,2020,16,1072,79,1019,53,5.2
Danemark,DNK,2020,17,1082,63,996,86,8.6
Danemark,DNK,2020,18,1043,63,1044,-1,-0.1
Danemark,DNK,2020,19,1022,34,1023,-1,-0.1
Danemark,DNK,2020,20,948,24,986,-38,-3.9
Danemark,DNK,2020,21,991,15,967,24,2.5
Danemark,DNK,2020,22,963,13,967,-4,-0.4
Danemark,DNK,2020,23,956,17,974,-18,-1.8
Danemark,DNK,2020,24,977,5,963,14,1.5
Espagne,ESP,2016,1,8658,NA,9929,-1271,-12.8
Espagne,ESP,2016,2,8671,NA,10252,-1581,-15.4
Espagne,ESP,2016,3,8791,NA,10395,-1604,-15.4
Espagne,ESP,2016,4,8491,NA,10006,-1515,-15.1
Espagne,ESP,2016,5,8461,NA,9738,-1277,-13.1
Espagne,ESP,2016,6,8556,NA,9477,-921,-9.7
Espagne,ESP,2016,7,8479,NA,9240,-761,-8.2
Espagne,ESP,2016,8,8670,NA,9052,-382,-4.2
Espagne,ESP,2016,9,8645,NA,8884,-239,-2.7
Espagne,ESP,2016,10,8653,NA,8664,-11,-0.1
Espagne,ESP,2016,11,8811,NA,8445,366,4.3
Espagne,ESP,2016,12,8291,NA,8201,90,1.1
Espagne,ESP,2016,13,8375,NA,8250,125,1.5
Espagne,ESP,2016,14,7998,NA,8077,-79,-1
Espagne,ESP,2016,15,7859,NA,8011,-152,-1.9
Espagne,ESP,2016,16,7589,NA,7769,-180,-2.3
Espagne,ESP,2016,17,7462,NA,7653,-191,-2.5
Espagne,ESP,2016,18,7606,NA,7557,49,0.6
Espagne,ESP,2016,19,7374,NA,7579,-205,-2.7
Espagne,ESP,2016,20,7533,NA,7518,15,0.2
Espagne,ESP,2016,21,7304,NA,7482,-178,-2.4
Espagne,ESP,2016,22,7255,NA,7318,-63,-0.9
Espagne,ESP,2016,23,7576,NA,7316,260,3.6
Espagne,ESP,2016,24,7140,NA,7281,-141,-1.9
Espagne,ESP,2016,25,7173,NA,7569,-396,-5.2
Espagne,ESP,2016,26,7345,NA,7436,-91,-1.2
Espagne,ESP,2016,27,7505,NA,7504,1,0
Espagne,ESP,2016,28,7423,NA,7365,58,0.8
Espagne,ESP,2016,29,7377,NA,7279,98,1.3
Espagne,ESP,2016,30,7295,NA,7255,40,0.6
Espagne,ESP,2016,31,7425,NA,7470,-45,-0.6
Espagne,ESP,2016,32,7233,NA,7434,-201,-2.7
Espagne,ESP,2016,33,7102,NA,7133,-31,-0.4
Espagne,ESP,2016,34,7184,NA,7082,102,1.4
Espagne,ESP,2016,35,7100,NA,6984,116,1.7
Espagne,ESP,2016,36,7203,NA,6920,283,4.1
Espagne,ESP,2016,37,6641,NA,6783,-142,-2.1
Espagne,ESP,2016,38,6956,NA,7048,-92,-1.3
Espagne,ESP,2016,39,7036,NA,7163,-127,-1.8
Espagne,ESP,2016,40,7072,NA,7158,-86,-1.2
Espagne,ESP,2016,41,7036,NA,7251,-215,-3
Espagne,ESP,2016,42,7185,NA,7305,-120,-1.6
Espagne,ESP,2016,43,7512,NA,7416,96,1.3
Espagne,ESP,2016,44,7244,NA,7554,-310,-4.1
Espagne,ESP,2016,45,7775,NA,7770,5,0.1
Espagne,ESP,2016,46,8076,NA,8038,38,0.5
Espagne,ESP,2016,47,8090,NA,8101,-11,-0.1
Espagne,ESP,2016,48,8321,NA,8198,123,1.5
Espagne,ESP,2016,49,8124,NA,8184,-60,-0.7
Espagne,ESP,2016,50,8612,NA,8606,6,0.1
Espagne,ESP,2016,51,8980,NA,8826,154,1.7
Espagne,ESP,2016,52,9855,NA,9258,597,6.4
Espagne,ESP,2017,1,10726,NA,9929,797,8
Espagne,ESP,2017,2,11414,NA,10252,1162,11.3
Espagne,ESP,2017,3,11334,NA,10395,939,9
Espagne,ESP,2017,4,11068,NA,10006,1062,10.6
Espagne,ESP,2017,5,10636,NA,9738,898,9.2
Espagne,ESP,2017,6,9660,NA,9477,183,1.9
Espagne,ESP,2017,7,9017,NA,9240,-223,-2.4
Espagne,ESP,2017,8,8670,NA,9052,-382,-4.2
Espagne,ESP,2017,9,8371,NA,8884,-513,-5.8
Espagne,ESP,2017,10,8213,NA,8664,-451,-5.2
Espagne,ESP,2017,11,7906,NA,8445,-539,-6.4
Espagne,ESP,2017,12,7875,NA,8201,-326,-4
Espagne,ESP,2017,13,7827,NA,8250,-423,-5.1
Espagne,ESP,2017,14,7814,NA,8077,-263,-3.3
Espagne,ESP,2017,15,7800,NA,8011,-211,-2.6
Espagne,ESP,2017,16,7574,NA,7769,-195,-2.5
Espagne,ESP,2017,17,7661,NA,7653,8,0.1
Espagne,ESP,2017,18,7520,NA,7557,-37,-0.5
Espagne,ESP,2017,19,7622,NA,7579,43,0.6
Espagne,ESP,2017,20,7494,NA,7518,-24,-0.3
Espagne,ESP,2017,21,7666,NA,7482,184,2.5
Espagne,ESP,2017,22,7092,NA,7318,-226,-3.1
Espagne,ESP,2017,23,7067,NA,7316,-249,-3.4
Espagne,ESP,2017,24,7819,NA,7281,538,7.4
Espagne,ESP,2017,25,7991,NA,7569,422,5.6
Espagne,ESP,2017,26,7137,NA,7436,-299,-4
Espagne,ESP,2017,27,7156,NA,7504,-348,-4.6
Espagne,ESP,2017,28,7214,NA,7365,-151,-2.1
Espagne,ESP,2017,29,7259,NA,7279,-20,-0.3
Espagne,ESP,2017,30,7110,NA,7255,-145,-2
Espagne,ESP,2017,31,7596,NA,7470,126,1.7
Espagne,ESP,2017,32,7186,NA,7434,-248,-3.3
Espagne,ESP,2017,33,7118,NA,7133,-15,-0.2
Espagne,ESP,2017,34,7219,NA,7082,137,1.9
Espagne,ESP,2017,35,7013,NA,6984,29,0.4
Espagne,ESP,2017,36,6680,NA,6920,-240,-3.5
Espagne,ESP,2017,37,6730,NA,6783,-53,-0.8
Espagne,ESP,2017,38,7091,NA,7048,43,0.6
Espagne,ESP,2017,39,7367,NA,7163,204,2.8
Espagne,ESP,2017,40,7388,NA,7158,230,3.2
Espagne,ESP,2017,41,7234,NA,7251,-17,-0.2
Espagne,ESP,2017,42,7392,NA,7305,87,1.2
Espagne,ESP,2017,43,7308,NA,7416,-108,-1.5
Espagne,ESP,2017,44,7511,NA,7554,-43,-0.6
Espagne,ESP,2017,45,7632,NA,7770,-138,-1.8
Espagne,ESP,2017,46,8063,NA,8038,25,0.3
Espagne,ESP,2017,47,8169,NA,8101,68,0.8
Espagne,ESP,2017,48,8257,NA,8198,59,0.7
Espagne,ESP,2017,49,8620,NA,8184,436,5.3
Espagne,ESP,2017,50,9262,NA,8606,656,7.6
Espagne,ESP,2017,51,9628,NA,8826,802,9.1
Espagne,ESP,2017,52,10412,NA,9258,1154,12.5
Espagne,ESP,2018,1,11204,NA,9929,1275,12.8
Espagne,ESP,2018,2,10905,NA,10252,653,6.4
Espagne,ESP,2018,3,10981,NA,10395,586,5.6
Espagne,ESP,2018,4,10324,NA,10006,318,3.2
Espagne,ESP,2018,5,9893,NA,9738,155,1.6
Espagne,ESP,2018,6,10015,NA,9477,538,5.7
Espagne,ESP,2018,7,10105,NA,9240,865,9.4
Espagne,ESP,2018,8,9656,NA,9052,604,6.7
Espagne,ESP,2018,9,9599,NA,8884,715,8
Espagne,ESP,2018,10,9203,NA,8664,539,6.2
Espagne,ESP,2018,11,8862,NA,8445,417,4.9
Espagne,ESP,2018,12,8616,NA,8201,415,5.1
Espagne,ESP,2018,13,8628,NA,8250,378,4.6
Espagne,ESP,2018,14,8414,NA,8077,337,4.2
Espagne,ESP,2018,15,8335,NA,8011,324,4
Espagne,ESP,2018,16,8112,NA,7769,343,4.4
Espagne,ESP,2018,17,7735,NA,7653,82,1.1
Espagne,ESP,2018,18,7359,NA,7557,-198,-2.6
Espagne,ESP,2018,19,7595,NA,7579,16,0.2
Espagne,ESP,2018,20,7511,NA,7518,-7,-0.1
Espagne,ESP,2018,21,7527,NA,7482,45,0.6
Espagne,ESP,2018,22,7306,NA,7318,-12,-0.2
Espagne,ESP,2018,23,7109,NA,7316,-207,-2.8
Espagne,ESP,2018,24,7154,NA,7281,-127,-1.7
Espagne,ESP,2018,25,7713,NA,7569,144,1.9
Espagne,ESP,2018,26,7698,NA,7436,262,3.5
Espagne,ESP,2018,27,7305,NA,7504,-199,-2.7
Espagne,ESP,2018,28,7366,NA,7365,1,0
Espagne,ESP,2018,29,7186,NA,7279,-93,-1.3
Espagne,ESP,2018,30,7155,NA,7255,-100,-1.4
Espagne,ESP,2018,31,7731,NA,7470,261,3.5
Espagne,ESP,2018,32,8003,NA,7434,569,7.7
Espagne,ESP,2018,33,7194,NA,7133,61,0.9
Espagne,ESP,2018,34,7015,NA,7082,-67,-0.9
Espagne,ESP,2018,35,6927,NA,6984,-57,-0.8
Espagne,ESP,2018,36,6906,NA,6920,-14,-0.2
Espagne,ESP,2018,37,6834,NA,6783,51,0.8
Espagne,ESP,2018,38,7153,NA,7048,105,1.5
Espagne,ESP,2018,39,7230,NA,7163,67,0.9
Espagne,ESP,2018,40,7210,NA,7158,52,0.7
Espagne,ESP,2018,41,7437,NA,7251,186,2.6
Espagne,ESP,2018,42,7350,NA,7305,45,0.6
Espagne,ESP,2018,43,7327,NA,7416,-89,-1.2
Espagne,ESP,2018,44,7794,NA,7554,240,3.2
Espagne,ESP,2018,45,8012,NA,7770,242,3.1
Espagne,ESP,2018,46,7999,NA,8038,-39,-0.5
Espagne,ESP,2018,47,7932,NA,8101,-169,-2.1
Espagne,ESP,2018,48,7929,NA,8198,-269,-3.3
Espagne,ESP,2018,49,8051,NA,8184,-133,-1.6
Espagne,ESP,2018,50,8312,NA,8606,-294,-3.4
Espagne,ESP,2018,51,8427,NA,8826,-399,-4.5
Espagne,ESP,2018,52,8650,NA,9258,-608,-6.6
Espagne,ESP,2019,1,9127,NA,9929,-802,-8.1
Espagne,ESP,2019,2,10019,NA,10252,-233,-2.3
Espagne,ESP,2019,3,10473,NA,10395,78,0.8
Espagne,ESP,2019,4,10141,NA,10006,135,1.3
Espagne,ESP,2019,5,9964,NA,9738,226,2.3
Espagne,ESP,2019,6,9676,NA,9477,199,2.1
Espagne,ESP,2019,7,9357,NA,9240,117,1.3
Espagne,ESP,2019,8,9210,NA,9052,158,1.7
Espagne,ESP,2019,9,8919,NA,8884,35,0.4
Espagne,ESP,2019,10,8588,NA,8664,-76,-0.9
Espagne,ESP,2019,11,8202,NA,8445,-243,-2.9
Espagne,ESP,2019,12,8022,NA,8201,-179,-2.2
Espagne,ESP,2019,13,8169,NA,8250,-81,-1
Espagne,ESP,2019,14,8081,NA,8077,4,0
Espagne,ESP,2019,15,8049,NA,8011,38,0.5
Espagne,ESP,2019,16,7802,NA,7769,33,0.4
Espagne,ESP,2019,17,7754,NA,7653,101,1.3
Espagne,ESP,2019,18,7742,NA,7557,185,2.4
Espagne,ESP,2019,19,7726,NA,7579,147,1.9
Espagne,ESP,2019,20,7535,NA,7518,17,0.2
Espagne,ESP,2019,21,7429,NA,7482,-53,-0.7
Espagne,ESP,2019,22,7619,NA,7318,301,4.1
Espagne,ESP,2019,23,7512,NA,7316,196,2.7
Espagne,ESP,2019,24,7010,NA,7281,-271,-3.7
Espagne,ESP,2019,25,7399,NA,7569,-170,-2.2
Espagne,ESP,2019,26,7566,NA,7436,130,1.7
Espagne,ESP,2019,27,8048,NA,7504,544,7.2
Espagne,ESP,2019,28,7457,NA,7365,92,1.2
Espagne,ESP,2019,29,7293,NA,7279,14,0.2
Espagne,ESP,2019,30,7461,NA,7255,206,2.8
Espagne,ESP,2019,31,7128,NA,7470,-342,-4.6
Espagne,ESP,2019,32,7313,NA,7434,-121,-1.6
Espagne,ESP,2019,33,7117,NA,7133,-16,-0.2
Espagne,ESP,2019,34,6908,NA,7082,-174,-2.5
Espagne,ESP,2019,35,6894,NA,6984,-90,-1.3
Espagne,ESP,2019,36,6890,NA,6920,-30,-0.4
Espagne,ESP,2019,37,6928,NA,6783,145,2.1
Espagne,ESP,2019,38,6994,NA,7048,-54,-0.8
Espagne,ESP,2019,39,7019,NA,7163,-144,-2
Espagne,ESP,2019,40,6963,NA,7158,-195,-2.7
Espagne,ESP,2019,41,7297,NA,7251,46,0.6
Espagne,ESP,2019,42,7292,NA,7305,-13,-0.2
Espagne,ESP,2019,43,7516,NA,7416,100,1.3
Espagne,ESP,2019,44,7668,NA,7554,114,1.5
Espagne,ESP,2019,45,7661,NA,7770,-109,-1.4
Espagne,ESP,2019,46,8016,NA,8038,-22,-0.3
Espagne,ESP,2019,47,8213,NA,8101,112,1.4
Espagne,ESP,2019,48,8287,NA,8198,89,1.1
Espagne,ESP,2019,49,7942,NA,8184,-242,-3
Espagne,ESP,2019,50,8239,NA,8606,-367,-4.3
Espagne,ESP,2019,51,8269,NA,8826,-557,-6.3
Espagne,ESP,2019,52,8113,NA,9258,-1145,-12.4
Espagne,ESP,2020,1,8897,0,9929,-1032,-10.4
Espagne,ESP,2020,2,9613,0,10252,-639,-6.2
Espagne,ESP,2020,3,10103,0,10395,-292,-2.8
Espagne,ESP,2020,4,9606,0,10006,-400,-4
Espagne,ESP,2020,5,9637,0,9738,-101,-1
Espagne,ESP,2020,6,9395,0,9477,-82,-0.9
Espagne,ESP,2020,7,8978,0,9240,-262,-2.8
Espagne,ESP,2020,8,8501,0,9052,-551,-6.1
Espagne,ESP,2020,9,7992,0,8884,-892,-10
Espagne,ESP,2020,10,8648,28,8664,-16,-0.2
Espagne,ESP,2020,11,9282,281,8445,837,9.9
Espagne,ESP,2020,12,12658,1873,8201,4457,54.3
Espagne,ESP,2020,13,19184,5158,8250,10934,132.5
Espagne,ESP,2020,14,20611,5715,8077,12534,155.2
Espagne,ESP,2020,15,17218,4434,8011,9207,114.9
Espagne,ESP,2020,16,13114,3793,7769,5345,68.8
Espagne,ESP,2020,17,10322,2540,7653,2669,34.9
Espagne,ESP,2020,18,8822,1791,7557,1265,16.7
Espagne,ESP,2020,19,8567,1307,7579,988,13
Espagne,ESP,2020,20,7550,858,7518,32,0.4
Espagne,ESP,2020,21,7614,-661,7482,132,1.8
Espagne,ESP,2020,22,6978,10,7318,-340,-4.6
Espagne,ESP,2020,23,6254,9,7316,-1062,-14.5
Estonie,EST,2016,1,322,NA,341,-19,-5.6
Estonie,EST,2016,2,334,NA,346,-12,-3.5
Estonie,EST,2016,3,301,NA,340,-39,-11.5
Estonie,EST,2016,4,335,NA,339,-4,-1.2
Estonie,EST,2016,5,319,NA,342,-23,-6.7
Estonie,EST,2016,6,353,NA,343,10,2.9
Estonie,EST,2016,7,276,NA,321,-45,-14
Estonie,EST,2016,8,313,NA,340,-27,-7.9
Estonie,EST,2016,9,317,NA,336,-19,-5.7
Estonie,EST,2016,10,293,NA,329,-36,-10.9
Estonie,EST,2016,11,303,NA,319,-16,-5
Estonie,EST,2016,12,263,NA,307,-44,-14.3
Estonie,EST,2016,13,323,NA,317,6,1.9
Estonie,EST,2016,14,312,NA,298,14,4.7
Estonie,EST,2016,15,307,NA,302,5,1.7
Estonie,EST,2016,16,298,NA,300,-2,-0.7
Estonie,EST,2016,17,295,NA,281,14,5
Estonie,EST,2016,18,304,NA,296,8,2.7
Estonie,EST,2016,19,299,NA,290,9,3.1
Estonie,EST,2016,20,288,NA,298,-10,-3.4
Estonie,EST,2016,21,276,NA,288,-12,-4.2
Estonie,EST,2016,22,277,NA,272,5,1.8
Estonie,EST,2016,23,258,NA,277,-19,-6.9
Estonie,EST,2016,24,276,NA,269,7,2.6
Estonie,EST,2016,25,270,NA,269,1,0.4
Estonie,EST,2016,26,263,NA,269,-6,-2.2
Estonie,EST,2016,27,251,NA,258,-7,-2.7
Estonie,EST,2016,28,270,NA,269,1,0.4
Estonie,EST,2016,29,276,NA,278,-2,-0.7
Estonie,EST,2016,30,264,NA,291,-27,-9.3
Estonie,EST,2016,31,232,NA,270,-38,-14.1
Estonie,EST,2016,32,280,NA,289,-9,-3.1
Estonie,EST,2016,33,285,NA,276,9,3.3
Estonie,EST,2016,34,278,NA,265,13,4.9
Estonie,EST,2016,35,271,NA,276,-5,-1.8
Estonie,EST,2016,36,283,NA,270,13,4.8
Estonie,EST,2016,37,278,NA,266,12,4.5
Estonie,EST,2016,38,295,NA,281,14,5
Estonie,EST,2016,39,305,NA,285,20,7
Estonie,EST,2016,40,282,NA,283,-1,-0.4
Estonie,EST,2016,41,284,NA,278,6,2.2
Estonie,EST,2016,42,313,NA,292,21,7.2
Estonie,EST,2016,43,313,NA,300,13,4.3
Estonie,EST,2016,44,303,NA,300,3,1
Estonie,EST,2016,45,330,NA,280,50,17.9
Estonie,EST,2016,46,299,NA,292,7,2.4
Estonie,EST,2016,47,292,NA,287,5,1.7
Estonie,EST,2016,48,284,NA,296,-12,-4.1
Estonie,EST,2016,49,286,NA,306,-20,-6.5
Estonie,EST,2016,50,312,NA,300,12,4
Estonie,EST,2016,51,309,NA,308,1,0.3
Estonie,EST,2016,52,364,NA,326,38,11.7
Estonie,EST,2017,1,364,NA,341,23,6.7
Estonie,EST,2017,2,393,NA,346,47,13.6
Estonie,EST,2017,3,386,NA,340,46,13.5
Estonie,EST,2017,4,360,NA,339,21,6.2
Estonie,EST,2017,5,392,NA,342,50,14.6
Estonie,EST,2017,6,351,NA,343,8,2.3
Estonie,EST,2017,7,344,NA,321,23,7.2
Estonie,EST,2017,8,337,NA,340,-3,-0.9
Estonie,EST,2017,9,304,NA,336,-32,-9.5
Estonie,EST,2017,10,328,NA,329,-1,-0.3
Estonie,EST,2017,11,296,NA,319,-23,-7.2
Estonie,EST,2017,12,304,NA,307,-3,-1
Estonie,EST,2017,13,322,NA,317,5,1.6
Estonie,EST,2017,14,286,NA,298,-12,-4
Estonie,EST,2017,15,293,NA,302,-9,-3
Estonie,EST,2017,16,285,NA,300,-15,-5
Estonie,EST,2017,17,267,NA,281,-14,-5
Estonie,EST,2017,18,308,NA,296,12,4.1
Estonie,EST,2017,19,319,NA,290,29,10
Estonie,EST,2017,20,292,NA,298,-6,-2
Estonie,EST,2017,21,290,NA,288,2,0.7
Estonie,EST,2017,22,268,NA,272,-4,-1.5
Estonie,EST,2017,23,293,NA,277,16,5.8
Estonie,EST,2017,24,262,NA,269,-7,-2.6
Estonie,EST,2017,25,247,NA,269,-22,-8.2
Estonie,EST,2017,26,272,NA,269,3,1.1
Estonie,EST,2017,27,290,NA,258,32,12.4
Estonie,EST,2017,28,249,NA,269,-20,-7.4
Estonie,EST,2017,29,242,NA,278,-36,-12.9
Estonie,EST,2017,30,296,NA,291,5,1.7
Estonie,EST,2017,31,272,NA,270,2,0.7
Estonie,EST,2017,32,304,NA,289,15,5.2
Estonie,EST,2017,33,260,NA,276,-16,-5.8
Estonie,EST,2017,34,270,NA,265,5,1.9
Estonie,EST,2017,35,305,NA,276,29,10.5
Estonie,EST,2017,36,259,NA,270,-11,-4.1
Estonie,EST,2017,37,265,NA,266,-1,-0.4
Estonie,EST,2017,38,267,NA,281,-14,-5
Estonie,EST,2017,39,271,NA,285,-14,-4.9
Estonie,EST,2017,40,273,NA,283,-10,-3.5
Estonie,EST,2017,41,269,NA,278,-9,-3.2
Estonie,EST,2017,42,285,NA,292,-7,-2.4
Estonie,EST,2017,43,291,NA,300,-9,-3
Estonie,EST,2017,44,324,NA,300,24,8
Estonie,EST,2017,45,262,NA,280,-18,-6.4
Estonie,EST,2017,46,299,NA,292,7,2.4
Estonie,EST,2017,47,267,NA,287,-20,-7
Estonie,EST,2017,48,324,NA,296,28,9.5
Estonie,EST,2017,49,294,NA,306,-12,-3.9
Estonie,EST,2017,50,264,NA,300,-36,-12
Estonie,EST,2017,51,301,NA,308,-7,-2.3
Estonie,EST,2017,52,310,NA,326,-16,-4.9
Estonie,EST,2018,1,328,NA,341,-13,-3.8
Estonie,EST,2018,2,319,NA,346,-27,-7.8
Estonie,EST,2018,3,290,NA,340,-50,-14.7
Estonie,EST,2018,4,338,NA,339,-1,-0.3
Estonie,EST,2018,5,333,NA,342,-9,-2.6
Estonie,EST,2018,6,343,NA,343,0,0
Estonie,EST,2018,7,347,NA,321,26,8.1
Estonie,EST,2018,8,389,NA,340,49,14.4
Estonie,EST,2018,9,391,NA,336,55,16.4
Estonie,EST,2018,10,391,NA,329,62,18.8
Estonie,EST,2018,11,384,NA,319,65,20.4
Estonie,EST,2018,12,361,NA,307,54,17.6
Estonie,EST,2018,13,326,NA,317,9,2.8
Estonie,EST,2018,14,337,NA,298,39,13.1
Estonie,EST,2018,15,319,NA,302,17,5.6
Estonie,EST,2018,16,318,NA,300,18,6
Estonie,EST,2018,17,276,NA,281,-5,-1.8
Estonie,EST,2018,18,269,NA,296,-27,-9.1
Estonie,EST,2018,19,268,NA,290,-22,-7.6
Estonie,EST,2018,20,300,NA,298,2,0.7
Estonie,EST,2018,21,281,NA,288,-7,-2.4
Estonie,EST,2018,22,266,NA,272,-6,-2.2
Estonie,EST,2018,23,262,NA,277,-15,-5.4
Estonie,EST,2018,24,282,NA,269,13,4.8
Estonie,EST,2018,25,277,NA,269,8,3
Estonie,EST,2018,26,261,NA,269,-8,-3
Estonie,EST,2018,27,230,NA,258,-28,-10.9
Estonie,EST,2018,28,280,NA,269,11,4.1
Estonie,EST,2018,29,310,NA,278,32,11.5
Estonie,EST,2018,30,291,NA,291,0,0
Estonie,EST,2018,31,321,NA,270,51,18.9
Estonie,EST,2018,32,302,NA,289,13,4.5
Estonie,EST,2018,33,234,NA,276,-42,-15.2
Estonie,EST,2018,34,261,NA,265,-4,-1.5
Estonie,EST,2018,35,255,NA,276,-21,-7.6
Estonie,EST,2018,36,278,NA,270,8,3
Estonie,EST,2018,37,265,NA,266,-1,-0.4
Estonie,EST,2018,38,284,NA,281,3,1.1
Estonie,EST,2018,39,283,NA,285,-2,-0.7
Estonie,EST,2018,40,273,NA,283,-10,-3.5
Estonie,EST,2018,41,301,NA,278,23,8.3
Estonie,EST,2018,42,282,NA,292,-10,-3.4
Estonie,EST,2018,43,299,NA,300,-1,-0.3
Estonie,EST,2018,44,282,NA,300,-18,-6
Estonie,EST,2018,45,259,NA,280,-21,-7.5
Estonie,EST,2018,46,284,NA,292,-8,-2.7
Estonie,EST,2018,47,289,NA,287,2,0.7
Estonie,EST,2018,48,283,NA,296,-13,-4.4
Estonie,EST,2018,49,316,NA,306,10,3.3
Estonie,EST,2018,50,319,NA,300,19,6.3
Estonie,EST,2018,51,318,NA,308,10,3.2
Estonie,EST,2018,52,329,NA,326,3,0.9
Estonie,EST,2019,1,351,NA,341,10,2.9
Estonie,EST,2019,2,338,NA,346,-8,-2.3
Estonie,EST,2019,3,383,NA,340,43,12.6
Estonie,EST,2019,4,324,NA,339,-15,-4.4
Estonie,EST,2019,5,325,NA,342,-17,-5
Estonie,EST,2019,6,325,NA,343,-18,-5.2
Estonie,EST,2019,7,317,NA,321,-4,-1.2
Estonie,EST,2019,8,322,NA,340,-18,-5.3
Estonie,EST,2019,9,331,NA,336,-5,-1.5
Estonie,EST,2019,10,305,NA,329,-24,-7.3
Estonie,EST,2019,11,294,NA,319,-25,-7.8
Estonie,EST,2019,12,300,NA,307,-7,-2.3
Estonie,EST,2019,13,296,NA,317,-21,-6.6
Estonie,EST,2019,14,257,NA,298,-41,-13.8
Estonie,EST,2019,15,290,NA,302,-12,-4
Estonie,EST,2019,16,299,NA,300,-1,-0.3
Estonie,EST,2019,17,286,NA,281,5,1.8
Estonie,EST,2019,18,301,NA,296,5,1.7
Estonie,EST,2019,19,274,NA,290,-16,-5.5
Estonie,EST,2019,20,313,NA,298,15,5
Estonie,EST,2019,21,303,NA,288,15,5.2
Estonie,EST,2019,22,276,NA,272,4,1.5
Estonie,EST,2019,23,296,NA,277,19,6.9
Estonie,EST,2019,24,257,NA,269,-12,-4.5
Estonie,EST,2019,25,281,NA,269,12,4.5
Estonie,EST,2019,26,279,NA,269,10,3.7
Estonie,EST,2019,27,263,NA,258,5,1.9
Estonie,EST,2019,28,278,NA,269,9,3.3
Estonie,EST,2019,29,286,NA,278,8,2.9
Estonie,EST,2019,30,314,NA,291,23,7.9
Estonie,EST,2019,31,256,NA,270,-14,-5.2
Estonie,EST,2019,32,269,NA,289,-20,-6.9
Estonie,EST,2019,33,323,NA,276,47,17
Estonie,EST,2019,34,251,NA,265,-14,-5.3
Estonie,EST,2019,35,271,NA,276,-5,-1.8
Estonie,EST,2019,36,261,NA,270,-9,-3.3
Estonie,EST,2019,37,254,NA,266,-12,-4.5
Estonie,EST,2019,38,277,NA,281,-4,-1.4
Estonie,EST,2019,39,282,NA,285,-3,-1.1
Estonie,EST,2019,40,305,NA,283,22,7.8
Estonie,EST,2019,41,257,NA,278,-21,-7.6
Estonie,EST,2019,42,286,NA,292,-6,-2.1
Estonie,EST,2019,43,296,NA,300,-4,-1.3
Estonie,EST,2019,44,293,NA,300,-7,-2.3
Estonie,EST,2019,45,271,NA,280,-9,-3.2
Estonie,EST,2019,46,288,NA,292,-4,-1.4
Estonie,EST,2019,47,299,NA,287,12,4.2
Estonie,EST,2019,48,291,NA,296,-5,-1.7
Estonie,EST,2019,49,327,NA,306,21,6.9
Estonie,EST,2019,50,304,NA,300,4,1.3
Estonie,EST,2019,51,305,NA,308,-3,-1
Estonie,EST,2019,52,302,NA,326,-24,-7.4
Estonie,EST,2020,1,294,0,341,-47,-13.8
Estonie,EST,2020,2,331,0,346,-15,-4.3
Estonie,EST,2020,3,316,0,340,-24,-7.1
Estonie,EST,2020,4,300,0,339,-39,-11.5
Estonie,EST,2020,5,308,0,342,-34,-9.9
Estonie,EST,2020,6,274,0,343,-69,-20.1
Estonie,EST,2020,7,322,0,321,1,0.3
Estonie,EST,2020,8,334,0,340,-6,-1.8
Estonie,EST,2020,9,313,0,336,-23,-6.8
Estonie,EST,2020,10,293,0,329,-36,-10.9
Estonie,EST,2020,11,337,0,319,18,5.6
Estonie,EST,2020,12,310,0,307,3,1
Estonie,EST,2020,13,327,3,317,10,3.2
Estonie,EST,2020,14,312,16,298,14,4.7
Estonie,EST,2020,15,313,9,302,11,3.6
Estonie,EST,2020,16,307,12,300,7,2.3
Estonie,EST,2020,17,323,10,281,42,14.9
Estonie,EST,2020,18,298,5,296,2,0.7
Estonie,EST,2020,19,311,6,290,21,7.2
Estonie,EST,2020,20,288,3,298,-10,-3.4
Estonie,EST,2020,21,273,1,288,-15,-5.2
Estonie,EST,2020,22,296,3,272,24,8.8
Estonie,EST,2020,23,264,1,277,-13,-4.7
Estonie,EST,2020,24,272,0,269,3,1.1
Estonie,EST,2020,25,251,0,269,-18,-6.7
Finlande,FIN,2016,1,1184,NA,1186,-2,-0.2
Finlande,FIN,2016,2,1192,NA,1186,6,0.5
Finlande,FIN,2016,3,1249,NA,1178,71,6
Finlande,FIN,2016,4,1186,NA,1149,37,3.2
Finlande,FIN,2016,5,1183,NA,1156,27,2.3
Finlande,FIN,2016,6,1167,NA,1138,29,2.5
Finlande,FIN,2016,7,1047,NA,1100,-53,-4.8
Finlande,FIN,2016,8,1046,NA,1100,-54,-4.9
Finlande,FIN,2016,9,1075,NA,1119,-44,-3.9
Finlande,FIN,2016,10,1023,NA,1095,-72,-6.6
Finlande,FIN,2016,11,1041,NA,1117,-76,-6.8
Finlande,FIN,2016,12,1095,NA,1106,-11,-1
Finlande,FIN,2016,13,1097,NA,1077,20,1.9
Finlande,FIN,2016,14,980,NA,1079,-99,-9.2
Finlande,FIN,2016,15,1010,NA,1040,-30,-2.9
Finlande,FIN,2016,16,1060,NA,1062,-2,-0.2
Finlande,FIN,2016,17,968,NA,1000,-32,-3.2
Finlande,FIN,2016,18,976,NA,1042,-66,-6.3
Finlande,FIN,2016,19,947,NA,987,-40,-4.1
Finlande,FIN,2016,20,963,NA,982,-19,-1.9
Finlande,FIN,2016,21,1023,NA,964,59,6.1
Finlande,FIN,2016,22,980,NA,951,29,3
Finlande,FIN,2016,23,913,NA,981,-68,-6.9
Finlande,FIN,2016,24,947,NA,956,-9,-0.9
Finlande,FIN,2016,25,939,NA,962,-23,-2.4
Finlande,FIN,2016,26,995,NA,957,38,4
Finlande,FIN,2016,27,874,NA,928,-54,-5.8
Finlande,FIN,2016,28,940,NA,958,-18,-1.9
Finlande,FIN,2016,29,949,NA,974,-25,-2.6
Finlande,FIN,2016,30,952,NA,991,-39,-3.9
Finlande,FIN,2016,31,902,NA,952,-50,-5.3
Finlande,FIN,2016,32,919,NA,938,-19,-2
Finlande,FIN,2016,33,946,NA,949,-3,-0.3
Finlande,FIN,2016,34,1006,NA,962,44,4.6
Finlande,FIN,2016,35,991,NA,964,27,2.8
Finlande,FIN,2016,36,991,NA,980,11,1.1
Finlande,FIN,2016,37,922,NA,965,-43,-4.5
Finlande,FIN,2016,38,1012,NA,989,23,2.3
Finlande,FIN,2016,39,983,NA,1004,-21,-2.1
Finlande,FIN,2016,40,986,NA,1031,-45,-4.4
Finlande,FIN,2016,41,1074,NA,1033,41,4
Finlande,FIN,2016,42,994,NA,1013,-19,-1.9
Finlande,FIN,2016,43,1025,NA,1032,-7,-0.7
Finlande,FIN,2016,44,1040,NA,1049,-9,-0.9
Finlande,FIN,2016,45,1071,NA,1019,52,5.1
Finlande,FIN,2016,46,1006,NA,992,14,1.4
Finlande,FIN,2016,47,1099,NA,1016,83,8.2
Finlande,FIN,2016,48,1044,NA,1024,20,2
Finlande,FIN,2016,49,1034,NA,1052,-18,-1.7
Finlande,FIN,2016,50,1069,NA,1061,8,0.8
Finlande,FIN,2016,51,1168,NA,1106,62,5.6
Finlande,FIN,2016,52,1321,NA,1176,145,12.3
Finlande,FIN,2017,1,1273,NA,1186,87,7.3
Finlande,FIN,2017,2,1335,NA,1186,149,12.6
Finlande,FIN,2017,3,1208,NA,1178,30,2.5
Finlande,FIN,2017,4,1145,NA,1149,-4,-0.3
Finlande,FIN,2017,5,1116,NA,1156,-40,-3.5
Finlande,FIN,2017,6,1106,NA,1138,-32,-2.8
Finlande,FIN,2017,7,1122,NA,1100,22,2
Finlande,FIN,2017,8,1124,NA,1100,24,2.2
Finlande,FIN,2017,9,1083,NA,1119,-36,-3.2
Finlande,FIN,2017,10,1048,NA,1095,-47,-4.3
Finlande,FIN,2017,11,1021,NA,1117,-96,-8.6
Finlande,FIN,2017,12,1065,NA,1106,-41,-3.7
Finlande,FIN,2017,13,985,NA,1077,-92,-8.5
Finlande,FIN,2017,14,1059,NA,1079,-20,-1.9
Finlande,FIN,2017,15,998,NA,1040,-42,-4
Finlande,FIN,2017,16,1055,NA,1062,-7,-0.7
Finlande,FIN,2017,17,1006,NA,1000,6,0.6
Finlande,FIN,2017,18,1079,NA,1042,37,3.6
Finlande,FIN,2017,19,1049,NA,987,62,6.3
Finlande,FIN,2017,20,999,NA,982,17,1.7
Finlande,FIN,2017,21,995,NA,964,31,3.2
Finlande,FIN,2017,22,980,NA,951,29,3
Finlande,FIN,2017,23,1014,NA,981,33,3.4
Finlande,FIN,2017,24,1021,NA,956,65,6.8
Finlande,FIN,2017,25,993,NA,962,31,3.2
Finlande,FIN,2017,26,993,NA,957,36,3.8
Finlande,FIN,2017,27,929,NA,928,1,0.1
Finlande,FIN,2017,28,921,NA,958,-37,-3.9
Finlande,FIN,2017,29,925,NA,974,-49,-5
Finlande,FIN,2017,30,944,NA,991,-47,-4.7
Finlande,FIN,2017,31,923,NA,952,-29,-3
Finlande,FIN,2017,32,954,NA,938,16,1.7
Finlande,FIN,2017,33,943,NA,949,-6,-0.6
Finlande,FIN,2017,34,906,NA,962,-56,-5.8
Finlande,FIN,2017,35,954,NA,964,-10,-1
Finlande,FIN,2017,36,1001,NA,980,21,2.1
Finlande,FIN,2017,37,1040,NA,965,75,7.8
Finlande,FIN,2017,38,940,NA,989,-49,-5
Finlande,FIN,2017,39,974,NA,1004,-30,-3
Finlande,FIN,2017,40,1030,NA,1031,-1,-0.1
Finlande,FIN,2017,41,964,NA,1033,-69,-6.7
Finlande,FIN,2017,42,1024,NA,1013,11,1.1
Finlande,FIN,2017,43,1024,NA,1032,-8,-0.8
Finlande,FIN,2017,44,1034,NA,1049,-15,-1.4
Finlande,FIN,2017,45,977,NA,1019,-42,-4.1
Finlande,FIN,2017,46,966,NA,992,-26,-2.6
Finlande,FIN,2017,47,998,NA,1016,-18,-1.8
Finlande,FIN,2017,48,988,NA,1024,-36,-3.5
Finlande,FIN,2017,49,1014,NA,1052,-38,-3.6
Finlande,FIN,2017,50,1056,NA,1061,-5,-0.5
Finlande,FIN,2017,51,1112,NA,1106,6,0.5
Finlande,FIN,2017,52,1103,NA,1176,-73,-6.2
Finlande,FIN,2018,1,1072,NA,1186,-114,-9.6
Finlande,FIN,2018,2,1091,NA,1186,-95,-8
Finlande,FIN,2018,3,1083,NA,1178,-95,-8.1
Finlande,FIN,2018,4,1131,NA,1149,-18,-1.6
Finlande,FIN,2018,5,1186,NA,1156,30,2.6
Finlande,FIN,2018,6,1110,NA,1138,-28,-2.5
Finlande,FIN,2018,7,1143,NA,1100,43,3.9
Finlande,FIN,2018,8,1173,NA,1100,73,6.6
Finlande,FIN,2018,9,1247,NA,1119,128,11.4
Finlande,FIN,2018,10,1223,NA,1095,128,11.7
Finlande,FIN,2018,11,1251,NA,1117,134,12
Finlande,FIN,2018,12,1216,NA,1106,110,9.9
Finlande,FIN,2018,13,1154,NA,1077,77,7.1
Finlande,FIN,2018,14,1243,NA,1079,164,15.2
Finlande,FIN,2018,15,1096,NA,1040,56,5.4
Finlande,FIN,2018,16,1110,NA,1062,48,4.5
Finlande,FIN,2018,17,1027,NA,1000,27,2.7
Finlande,FIN,2018,18,1023,NA,1042,-19,-1.8
Finlande,FIN,2018,19,980,NA,987,-7,-0.7
Finlande,FIN,2018,20,973,NA,982,-9,-0.9
Finlande,FIN,2018,21,909,NA,964,-55,-5.7
Finlande,FIN,2018,22,926,NA,951,-25,-2.6
Finlande,FIN,2018,23,944,NA,981,-37,-3.8
Finlande,FIN,2018,24,921,NA,956,-35,-3.7
Finlande,FIN,2018,25,954,NA,962,-8,-0.8
Finlande,FIN,2018,26,946,NA,957,-11,-1.1
Finlande,FIN,2018,27,961,NA,928,33,3.6
Finlande,FIN,2018,28,986,NA,958,28,2.9
Finlande,FIN,2018,29,1060,NA,974,86,8.8
Finlande,FIN,2018,30,1047,NA,991,56,5.7
Finlande,FIN,2018,31,1063,NA,952,111,11.7
Finlande,FIN,2018,32,919,NA,938,-19,-2
Finlande,FIN,2018,33,984,NA,949,35,3.7
Finlande,FIN,2018,34,943,NA,962,-19,-2
Finlande,FIN,2018,35,947,NA,964,-17,-1.8
Finlande,FIN,2018,36,941,NA,980,-39,-4
Finlande,FIN,2018,37,907,NA,965,-58,-6
Finlande,FIN,2018,38,997,NA,989,8,0.8
Finlande,FIN,2018,39,1012,NA,1004,8,0.8
Finlande,FIN,2018,40,1059,NA,1031,28,2.7
Finlande,FIN,2018,41,1004,NA,1033,-29,-2.8
Finlande,FIN,2018,42,982,NA,1013,-31,-3.1
Finlande,FIN,2018,43,999,NA,1032,-33,-3.2
Finlande,FIN,2018,44,1021,NA,1049,-28,-2.7
Finlande,FIN,2018,45,1031,NA,1019,12,1.2
Finlande,FIN,2018,46,983,NA,992,-9,-0.9
Finlande,FIN,2018,47,995,NA,1016,-21,-2.1
Finlande,FIN,2018,48,1038,NA,1024,14,1.4
Finlande,FIN,2018,49,1063,NA,1052,11,1
Finlande,FIN,2018,50,1065,NA,1061,4,0.4
Finlande,FIN,2018,51,1037,NA,1106,-69,-6.2
Finlande,FIN,2018,52,1193,NA,1176,17,1.4
Finlande,FIN,2019,1,1213,NA,1186,27,2.3
Finlande,FIN,2019,2,1125,NA,1186,-61,-5.1
Finlande,FIN,2019,3,1171,NA,1178,-7,-0.6
Finlande,FIN,2019,4,1134,NA,1149,-15,-1.3
Finlande,FIN,2019,5,1141,NA,1156,-15,-1.3
Finlande,FIN,2019,6,1170,NA,1138,32,2.8
Finlande,FIN,2019,7,1089,NA,1100,-11,-1
Finlande,FIN,2019,8,1058,NA,1100,-42,-3.8
Finlande,FIN,2019,9,1070,NA,1119,-49,-4.4
Finlande,FIN,2019,10,1085,NA,1095,-10,-0.9
Finlande,FIN,2019,11,1154,NA,1117,37,3.3
Finlande,FIN,2019,12,1047,NA,1106,-59,-5.3
Finlande,FIN,2019,13,1072,NA,1077,-5,-0.5
Finlande,FIN,2019,14,1033,NA,1079,-46,-4.3
Finlande,FIN,2019,15,1058,NA,1040,18,1.7
Finlande,FIN,2019,16,1024,NA,1062,-38,-3.6
Finlande,FIN,2019,17,1001,NA,1000,1,0.1
Finlande,FIN,2019,18,1090,NA,1042,48,4.6
Finlande,FIN,2019,19,972,NA,987,-15,-1.5
Finlande,FIN,2019,20,993,NA,982,11,1.1
Finlande,FIN,2019,21,927,NA,964,-37,-3.8
Finlande,FIN,2019,22,919,NA,951,-32,-3.4
Finlande,FIN,2019,23,1053,NA,981,72,7.3
Finlande,FIN,2019,24,934,NA,956,-22,-2.3
Finlande,FIN,2019,25,962,NA,962,0,0
Finlande,FIN,2019,26,895,NA,957,-62,-6.5
Finlande,FIN,2019,27,949,NA,928,21,2.3
Finlande,FIN,2019,28,983,NA,958,25,2.6
Finlande,FIN,2019,29,962,NA,974,-12,-1.2
Finlande,FIN,2019,30,1022,NA,991,31,3.1
Finlande,FIN,2019,31,922,NA,952,-30,-3.2
Finlande,FIN,2019,32,958,NA,938,20,2.1
Finlande,FIN,2019,33,923,NA,949,-26,-2.7
Finlande,FIN,2019,34,992,NA,962,30,3.1
Finlande,FIN,2019,35,966,NA,964,2,0.2
Finlande,FIN,2019,36,986,NA,980,6,0.6
Finlande,FIN,2019,37,990,NA,965,25,2.6
Finlande,FIN,2019,38,1007,NA,989,18,1.8
Finlande,FIN,2019,39,1047,NA,1004,43,4.3
Finlande,FIN,2019,40,1050,NA,1031,19,1.8
Finlande,FIN,2019,41,1090,NA,1033,57,5.5
Finlande,FIN,2019,42,1052,NA,1013,39,3.8
Finlande,FIN,2019,43,1081,NA,1032,49,4.7
Finlande,FIN,2019,44,1101,NA,1049,52,5
Finlande,FIN,2019,45,997,NA,1019,-22,-2.2
Finlande,FIN,2019,46,1014,NA,992,22,2.2
Finlande,FIN,2019,47,970,NA,1016,-46,-4.5
Finlande,FIN,2019,48,1024,NA,1024,0,0
Finlande,FIN,2019,49,1097,NA,1052,45,4.3
Finlande,FIN,2019,50,1053,NA,1061,-8,-0.8
Finlande,FIN,2019,51,1105,NA,1106,-1,-0.1
Finlande,FIN,2019,52,1089,NA,1176,-87,-7.4
Finlande,FIN,2020,1,1044,0,1186,-142,-12
Finlande,FIN,2020,2,1068,0,1186,-118,-9.9
Finlande,FIN,2020,3,1057,0,1178,-121,-10.3
Finlande,FIN,2020,4,1039,0,1149,-110,-9.6
Finlande,FIN,2020,5,1073,0,1156,-83,-7.2
Finlande,FIN,2020,6,1115,0,1138,-23,-2
Finlande,FIN,2020,7,1098,0,1100,-2,-0.2
Finlande,FIN,2020,8,1088,0,1100,-12,-1.1
Finlande,FIN,2020,9,1048,0,1119,-71,-6.3
Finlande,FIN,2020,10,1100,0,1095,5,0.5
Finlande,FIN,2020,11,1097,0,1117,-20,-1.8
Finlande,FIN,2020,12,1118,1,1106,12,1.1
Finlande,FIN,2020,13,1106,12,1077,29,2.7
Finlande,FIN,2020,14,1104,14,1079,25,2.3
Finlande,FIN,2020,15,1178,32,1040,138,13.3
Finlande,FIN,2020,16,1090,39,1062,28,2.6
Finlande,FIN,2020,17,1129,95,1000,129,12.9
Finlande,FIN,2020,18,1122,47,1042,80,7.7
Finlande,FIN,2020,19,1061,31,987,74,7.5
Finlande,FIN,2020,20,1090,29,982,108,11
Finlande,FIN,2020,21,932,8,964,-32,-3.3
Finlande,FIN,2020,22,953,12,951,2,0.2
Finlande,FIN,2020,23,888,3,981,-93,-9.5
France,FRA,2016,1,12183,NA,13858,-1675,-12.1
France,FRA,2016,2,12247,NA,13919,-1672,-12
France,FRA,2016,3,12403,NA,13571,-1168,-8.6
France,FRA,2016,4,12065,NA,13430,-1365,-10.2
France,FRA,2016,5,11963,NA,13270,-1307,-9.8
France,FRA,2016,6,12059,NA,13243,-1184,-8.9
France,FRA,2016,7,11846,NA,12858,-1012,-7.9
France,FRA,2016,8,11753,NA,12775,-1022,-8
France,FRA,2016,9,12252,NA,13012,-760,-5.8
France,FRA,2016,10,12158,NA,12790,-632,-4.9
France,FRA,2016,11,12309,NA,12232,77,0.6
France,FRA,2016,12,12111,NA,11962,149,1.2
France,FRA,2016,13,12212,NA,11880,332,2.8
France,FRA,2016,14,11826,NA,11673,153,1.3
France,FRA,2016,15,11456,NA,11378,78,0.7
France,FRA,2016,16,10923,NA,11302,-379,-3.4
France,FRA,2016,17,10963,NA,11190,-227,-2
France,FRA,2016,18,11097,NA,11050,47,0.4
France,FRA,2016,19,10931,NA,10929,2,0
France,FRA,2016,20,10769,NA,10877,-108,-1
France,FRA,2016,21,10720,NA,10911,-191,-1.8
France,FRA,2016,22,10266,NA,10519,-253,-2.4
France,FRA,2016,23,10553,NA,10400,153,1.5
France,FRA,2016,24,10154,NA,10326,-172,-1.7
France,FRA,2016,25,10650,NA,10734,-84,-0.8
France,FRA,2016,26,10310,NA,10693,-383,-3.6
France,FRA,2016,27,10712,NA,10886,-174,-1.6
France,FRA,2016,28,10399,NA,10450,-51,-0.5
France,FRA,2016,29,11162,NA,10758,404,3.8
France,FRA,2016,30,10116,NA,10836,-720,-6.6
France,FRA,2016,31,10061,NA,10526,-465,-4.4
France,FRA,2016,32,10030,NA,10436,-406,-3.9
France,FRA,2016,33,10451,NA,10294,157,1.5
France,FRA,2016,34,10760,NA,10656,104,1
France,FRA,2016,35,10313,NA,10576,-263,-2.5
France,FRA,2016,36,10421,NA,10390,31,0.3
France,FRA,2016,37,10442,NA,10658,-216,-2
France,FRA,2016,38,10499,NA,10939,-440,-4
France,FRA,2016,39,10733,NA,10919,-186,-1.7
France,FRA,2016,40,10906,NA,11156,-250,-2.2
France,FRA,2016,41,11495,NA,11398,97,0.9
France,FRA,2016,42,11607,NA,11278,329,2.9
France,FRA,2016,43,11594,NA,11375,219,1.9
France,FRA,2016,44,11389,NA,11430,-41,-0.4
France,FRA,2016,45,11592,NA,11663,-71,-0.6
France,FRA,2016,46,11919,NA,11759,160,1.4
France,FRA,2016,47,11632,NA,11886,-254,-2.1
France,FRA,2016,48,11636,NA,11928,-292,-2.4
France,FRA,2016,49,12147,NA,12043,104,0.9
France,FRA,2016,50,12508,NA,12381,127,1
France,FRA,2016,51,13474,NA,12821,653,5.1
France,FRA,2016,52,14659,NA,13246,1413,10.7
France,FRA,2017,1,15777,NA,13858,1919,13.8
France,FRA,2017,2,15953,NA,13919,2034,14.6
France,FRA,2017,3,14956,NA,13571,1385,10.2
France,FRA,2017,4,15033,NA,13430,1603,11.9
France,FRA,2017,5,14514,NA,13270,1244,9.4
France,FRA,2017,6,13650,NA,13243,407,3.1
France,FRA,2017,7,12848,NA,12858,-10,-0.1
France,FRA,2017,8,12231,NA,12775,-544,-4.3
France,FRA,2017,9,11960,NA,13012,-1052,-8.1
France,FRA,2017,10,11699,NA,12790,-1091,-8.5
France,FRA,2017,11,11254,NA,12232,-978,-8
France,FRA,2017,12,10996,NA,11962,-966,-8.1
France,FRA,2017,13,11009,NA,11880,-871,-7.3
France,FRA,2017,14,10880,NA,11673,-793,-6.8
France,FRA,2017,15,10872,NA,11378,-506,-4.4
France,FRA,2017,16,10916,NA,11302,-386,-3.4
France,FRA,2017,17,11242,NA,11190,52,0.5
France,FRA,2017,18,11096,NA,11050,46,0.4
France,FRA,2017,19,10941,NA,10929,12,0.1
France,FRA,2017,20,10865,NA,10877,-12,-0.1
France,FRA,2017,21,10846,NA,10911,-65,-0.6
France,FRA,2017,22,10375,NA,10519,-144,-1.4
France,FRA,2017,23,10086,NA,10400,-314,-3
France,FRA,2017,24,10334,NA,10326,8,0.1
France,FRA,2017,25,11076,NA,10734,342,3.2
France,FRA,2017,26,9926,NA,10693,-767,-7.2
France,FRA,2017,27,10821,NA,10886,-65,-0.6
France,FRA,2017,28,10334,NA,10450,-116,-1.1
France,FRA,2017,29,10529,NA,10758,-229,-2.1
France,FRA,2017,30,10410,NA,10836,-426,-3.9
France,FRA,2017,31,10672,NA,10526,146,1.4
France,FRA,2017,32,10133,NA,10436,-303,-2.9
France,FRA,2017,33,10326,NA,10294,32,0.3
France,FRA,2017,34,10644,NA,10656,-12,-0.1
France,FRA,2017,35,10558,NA,10576,-18,-0.2
France,FRA,2017,36,10021,NA,10390,-369,-3.6
France,FRA,2017,37,10611,NA,10658,-47,-0.4
France,FRA,2017,38,11341,NA,10939,402,3.7
France,FRA,2017,39,11476,NA,10919,557,5.1
France,FRA,2017,40,11220,NA,11156,64,0.6
France,FRA,2017,41,11350,NA,11398,-48,-0.4
France,FRA,2017,42,11080,NA,11278,-198,-1.8
France,FRA,2017,43,11201,NA,11375,-174,-1.5
France,FRA,2017,44,11247,NA,11430,-183,-1.6
France,FRA,2017,45,11535,NA,11663,-128,-1.1
France,FRA,2017,46,11653,NA,11759,-106,-0.9
France,FRA,2017,47,11840,NA,11886,-46,-0.4
France,FRA,2017,48,12013,NA,11928,85,0.7
France,FRA,2017,49,12278,NA,12043,235,2
France,FRA,2017,50,12832,NA,12381,451,3.6
France,FRA,2017,51,12936,NA,12821,115,0.9
France,FRA,2017,52,13709,NA,13246,463,3.5
France,FRA,2018,1,14389,NA,13858,531,3.8
France,FRA,2018,2,13866,NA,13919,-53,-0.4
France,FRA,2018,3,13429,NA,13571,-142,-1
France,FRA,2018,4,12695,NA,13430,-735,-5.5
France,FRA,2018,5,12409,NA,13270,-861,-6.5
France,FRA,2018,6,12950,NA,13243,-293,-2.2
France,FRA,2018,7,12894,NA,12858,36,0.3
France,FRA,2018,8,13383,NA,12775,608,4.8
France,FRA,2018,9,14473,NA,13012,1461,11.2
France,FRA,2018,10,14595,NA,12790,1805,14.1
France,FRA,2018,11,13387,NA,12232,1155,9.4
France,FRA,2018,12,12932,NA,11962,970,8.1
France,FRA,2018,13,12718,NA,11880,838,7.1
France,FRA,2018,14,12263,NA,11673,590,5.1
France,FRA,2018,15,11930,NA,11378,552,4.9
France,FRA,2018,16,11822,NA,11302,520,4.6
France,FRA,2018,17,11061,NA,11190,-129,-1.2
France,FRA,2018,18,10915,NA,11050,-135,-1.2
France,FRA,2018,19,10577,NA,10929,-352,-3.2
France,FRA,2018,20,10678,NA,10877,-199,-1.8
France,FRA,2018,21,11024,NA,10911,113,1
France,FRA,2018,22,10738,NA,10519,219,2.1
France,FRA,2018,23,10372,NA,10400,-28,-0.3
France,FRA,2018,24,10246,NA,10326,-80,-0.8
France,FRA,2018,25,10454,NA,10734,-280,-2.6
France,FRA,2018,26,11136,NA,10693,443,4.1
France,FRA,2018,27,11011,NA,10886,125,1.1
France,FRA,2018,28,10513,NA,10450,63,0.6
France,FRA,2018,29,10738,NA,10758,-20,-0.2
France,FRA,2018,30,11196,NA,10836,360,3.3
France,FRA,2018,31,11002,NA,10526,476,4.5
France,FRA,2018,32,10994,NA,10436,558,5.3
France,FRA,2018,33,10163,NA,10294,-131,-1.3
France,FRA,2018,34,10618,NA,10656,-38,-0.4
France,FRA,2018,35,10363,NA,10576,-213,-2
France,FRA,2018,36,10754,NA,10390,364,3.5
France,FRA,2018,37,10785,NA,10658,127,1.2
France,FRA,2018,38,10772,NA,10939,-167,-1.5
France,FRA,2018,39,10689,NA,10919,-230,-2.1
France,FRA,2018,40,11310,NA,11156,154,1.4
France,FRA,2018,41,11391,NA,11398,-7,-0.1
France,FRA,2018,42,11012,NA,11278,-266,-2.4
France,FRA,2018,43,11258,NA,11375,-117,-1
France,FRA,2018,44,11436,NA,11430,6,0.1
France,FRA,2018,45,11712,NA,11663,49,0.4
France,FRA,2018,46,11474,NA,11759,-285,-2.4
France,FRA,2018,47,11706,NA,11886,-180,-1.5
France,FRA,2018,48,11811,NA,11928,-117,-1
France,FRA,2018,49,11567,NA,12043,-476,-4
France,FRA,2018,50,11733,NA,12381,-648,-5.2
France,FRA,2018,51,12260,NA,12821,-561,-4.4
France,FRA,2018,52,12182,NA,13246,-1064,-8
France,FRA,2019,1,13082,NA,13858,-776,-5.6
France,FRA,2019,2,13609,NA,13919,-310,-2.2
France,FRA,2019,3,13496,NA,13571,-75,-0.6
France,FRA,2019,4,13928,NA,13430,498,3.7
France,FRA,2019,5,14196,NA,13270,926,7
France,FRA,2019,6,14313,NA,13243,1070,8.1
France,FRA,2019,7,13843,NA,12858,985,7.7
France,FRA,2019,8,13734,NA,12775,959,7.5
France,FRA,2019,9,13363,NA,13012,351,2.7
France,FRA,2019,10,12707,NA,12790,-83,-0.6
France,FRA,2019,11,11976,NA,12232,-256,-2.1
France,FRA,2019,12,11811,NA,11962,-151,-1.3
France,FRA,2019,13,11579,NA,11880,-301,-2.5
France,FRA,2019,14,11724,NA,11673,51,0.4
France,FRA,2019,15,11254,NA,11378,-124,-1.1
France,FRA,2019,16,11546,NA,11302,244,2.2
France,FRA,2019,17,11496,NA,11190,306,2.7
France,FRA,2019,18,11093,NA,11050,43,0.4
France,FRA,2019,19,11266,NA,10929,337,3.1
France,FRA,2019,20,11195,NA,10877,318,2.9
France,FRA,2019,21,11053,NA,10911,142,1.3
France,FRA,2019,22,10696,NA,10519,177,1.7
France,FRA,2019,23,10591,NA,10400,191,1.8
France,FRA,2019,24,10571,NA,10326,245,2.4
France,FRA,2019,25,10756,NA,10734,22,0.2
France,FRA,2019,26,11400,NA,10693,707,6.6
France,FRA,2019,27,10998,NA,10886,112,1
France,FRA,2019,28,10555,NA,10450,105,1
France,FRA,2019,29,10603,NA,10758,-155,-1.4
France,FRA,2019,30,11623,NA,10836,787,7.3
France,FRA,2019,31,10369,NA,10526,-157,-1.5
France,FRA,2019,32,10589,NA,10436,153,1.5
France,FRA,2019,33,10235,NA,10294,-59,-0.6
France,FRA,2019,34,10604,NA,10656,-52,-0.5
France,FRA,2019,35,11071,NA,10576,495,4.7
France,FRA,2019,36,10362,NA,10390,-28,-0.3
France,FRA,2019,37,10796,NA,10658,138,1.3
France,FRA,2019,38,11143,NA,10939,204,1.9
France,FRA,2019,39,10779,NA,10919,-140,-1.3
France,FRA,2019,40,11188,NA,11156,32,0.3
France,FRA,2019,41,11358,NA,11398,-40,-0.4
France,FRA,2019,42,11414,NA,11278,136,1.2
France,FRA,2019,43,11448,NA,11375,73,0.6
France,FRA,2019,44,11646,NA,11430,216,1.9
France,FRA,2019,45,11814,NA,11663,151,1.3
France,FRA,2019,46,11989,NA,11759,230,2
France,FRA,2019,47,12365,NA,11886,479,4
France,FRA,2019,48,12250,NA,11928,322,2.7
France,FRA,2019,49,12180,NA,12043,137,1.1
France,FRA,2019,50,12451,NA,12381,70,0.6
France,FRA,2019,51,12613,NA,12821,-208,-1.6
France,FRA,2019,52,12433,NA,13246,-813,-6.1
France,FRA,2020,1,12961,0,13858,-897,-6.5
France,FRA,2020,2,13419,0,13919,-500,-3.6
France,FRA,2020,3,12820,0,13571,-751,-5.5
France,FRA,2020,4,12570,0,13430,-860,-6.4
France,FRA,2020,5,12756,0,13270,-514,-3.9
France,FRA,2020,6,12641,0,13243,-602,-4.5
France,FRA,2020,7,12492,1,12858,-366,-2.8
France,FRA,2020,8,12069,0,12775,-706,-5.5
France,FRA,2020,9,12254,2,13012,-758,-5.8
France,FRA,2020,10,12382,27,12790,-408,-3.2
France,FRA,2020,11,12763,118,12232,531,4.3
France,FRA,2020,12,14155,712,11962,2193,18.3
France,FRA,2020,13,16380,2164,11880,4500,37.9
France,FRA,2020,14,18997,5887,11673,7324,62.7
France,FRA,2020,15,17726,6056,11378,6348,55.8
France,FRA,2020,16,15585,5298,11302,4283,37.9
France,FRA,2020,17,12975,3028,11190,1785,16
France,FRA,2020,18,11437,1908,11050,387,3.5
France,FRA,2020,19,11192,1442,10929,263,2.4
France,FRA,2020,20,10846,1254,10877,-31,-0.3
France,FRA,2020,21,11200,535,10911,289,2.6
France,FRA,2020,22,10378,401,10519,-141,-1.3
France,FRA,2020,23,10106,376,10400,-294,-2.8
Royaume-Uni,GBR,2016,1,54911,NA,51304,3607,7
Royaume-Uni,GBR,2016,2,48518,NA,55805,-7287,-13.1
Royaume-Uni,GBR,2016,3,48250,NA,53804,-5554,-10.3
Royaume-Uni,GBR,2016,4,47542,NA,52329,-4787,-9.1
Royaume-Uni,GBR,2016,5,46463,NA,50526,-4063,-8
Royaume-Uni,GBR,2016,6,46959,NA,49848,-2889,-5.8
Royaume-Uni,GBR,2016,7,44040,NA,48479,-4439,-9.2
Royaume-Uni,GBR,2016,8,45928,NA,48420,-2492,-5.1
Royaume-Uni,GBR,2016,9,47255,NA,46577,678,1.5
Royaume-Uni,GBR,2016,10,46182,NA,48340,-2158,-4.5
Royaume-Uni,GBR,2016,11,46197,NA,47132,-935,-2
Royaume-Uni,GBR,2016,12,40454,NA,44288,-3834,-8.7
Royaume-Uni,GBR,2016,13,43240,NA,42101,1139,2.7
Royaume-Uni,GBR,2016,14,48522,NA,44496,4026,9
Royaume-Uni,GBR,2016,15,47508,NA,44425,3083,6.9
Royaume-Uni,GBR,2016,16,45663,NA,42683,2980,7
Royaume-Uni,GBR,2016,17,43703,NA,43749,-46,-0.1
Royaume-Uni,GBR,2016,18,38414,NA,41521,-3107,-7.5
Royaume-Uni,GBR,2016,19,44536,NA,41005,3531,8.6
Royaume-Uni,GBR,2016,20,41670,NA,42621,-951,-2.2
Royaume-Uni,GBR,2016,21,40832,NA,41649,-817,-2
Royaume-Uni,GBR,2016,22,33669,NA,34621,-952,-2.7
Royaume-Uni,GBR,2016,23,41435,NA,41717,-282,-0.7
Royaume-Uni,GBR,2016,24,39471,NA,39439,32,0.1
Royaume-Uni,GBR,2016,25,39337,NA,39642,-305,-0.8
Royaume-Uni,GBR,2016,26,38866,NA,39252,-386,-1
Royaume-Uni,GBR,2016,27,38522,NA,38604,-82,-0.2
Royaume-Uni,GBR,2016,28,39411,NA,39170,241,0.6
Royaume-Uni,GBR,2016,29,39379,NA,38548,831,2.2
Royaume-Uni,GBR,2016,30,39173,NA,38324,849,2.2
Royaume-Uni,GBR,2016,31,38563,NA,38430,133,0.3
Royaume-Uni,GBR,2016,32,38473,NA,38514,-41,-0.1
Royaume-Uni,GBR,2016,33,38115,NA,38165,-50,-0.1
Royaume-Uni,GBR,2016,34,39212,NA,38550,662,1.7
Royaume-Uni,GBR,2016,35,33735,NA,34060,-325,-1
Royaume-Uni,GBR,2016,36,39530,NA,39940,-410,-1
Royaume-Uni,GBR,2016,37,38387,NA,39194,-807,-2.1
Royaume-Uni,GBR,2016,38,37597,NA,39156,-1559,-4
Royaume-Uni,GBR,2016,39,37877,NA,39358,-1481,-3.8
Royaume-Uni,GBR,2016,40,39293,NA,40387,-1094,-2.7
Royaume-Uni,GBR,2016,41,40826,NA,41362,-536,-1.3
Royaume-Uni,GBR,2016,42,41141,NA,41852,-711,-1.7
Royaume-Uni,GBR,2016,43,40830,NA,41083,-253,-0.6
Royaume-Uni,GBR,2016,44,42520,NA,41864,656,1.6
Royaume-Uni,GBR,2016,45,43848,NA,43781,67,0.2
Royaume-Uni,GBR,2016,46,45020,NA,43996,1024,2.3
Royaume-Uni,GBR,2016,47,44601,NA,44257,344,0.8
Royaume-Uni,GBR,2016,48,43989,NA,44173,-184,-0.4
Royaume-Uni,GBR,2016,49,47150,NA,45321,1829,4
Royaume-Uni,GBR,2016,50,44498,NA,45953,-1455,-3.2
Royaume-Uni,GBR,2016,51,48461,NA,49390,-929,-1.9
Royaume-Uni,GBR,2017,1,50374,NA,51304,-930,-1.8
Royaume-Uni,GBR,2017,2,57583,NA,55805,1778,3.2
Royaume-Uni,GBR,2017,3,56772,NA,53804,2968,5.5
Royaume-Uni,GBR,2017,4,53735,NA,52329,1406,2.7
Royaume-Uni,GBR,2017,5,52519,NA,50526,1993,3.9
Royaume-Uni,GBR,2017,6,51353,NA,49848,1505,3
Royaume-Uni,GBR,2017,7,48989,NA,48479,510,1.1
Royaume-Uni,GBR,2017,8,49481,NA,48420,1061,2.2
Royaume-Uni,GBR,2017,9,47368,NA,46577,791,1.7
Royaume-Uni,GBR,2017,10,46629,NA,48340,-1711,-3.5
Royaume-Uni,GBR,2017,11,44868,NA,47132,-2264,-4.8
Royaume-Uni,GBR,2017,12,43630,NA,44288,-658,-1.5
Royaume-Uni,GBR,2017,13,42221,NA,42101,120,0.3
Royaume-Uni,GBR,2017,14,41753,NA,44496,-2743,-6.2
Royaume-Uni,GBR,2017,15,35871,NA,44425,-8554,-19.3
Royaume-Uni,GBR,2017,16,40556,NA,42683,-2127,-5
Royaume-Uni,GBR,2017,17,45753,NA,43749,2004,4.6
Royaume-Uni,GBR,2017,18,38224,NA,41521,-3297,-7.9
Royaume-Uni,GBR,2017,19,44855,NA,41005,3850,9.4
Royaume-Uni,GBR,2017,20,43316,NA,42621,695,1.6
Royaume-Uni,GBR,2017,21,42253,NA,41649,604,1.5
Royaume-Uni,GBR,2017,22,35215,NA,34621,594,1.7
Royaume-Uni,GBR,2017,23,41153,NA,41717,-564,-1.4
Royaume-Uni,GBR,2017,24,39441,NA,39439,2,0
Royaume-Uni,GBR,2017,25,40431,NA,39642,789,2
Royaume-Uni,GBR,2017,26,39298,NA,39252,46,0.1
Royaume-Uni,GBR,2017,27,39034,NA,38604,430,1.1
Royaume-Uni,GBR,2017,28,39399,NA,39170,229,0.6
Royaume-Uni,GBR,2017,29,38422,NA,38548,-126,-0.3
Royaume-Uni,GBR,2017,30,37382,NA,38324,-942,-2.5
Royaume-Uni,GBR,2017,31,37686,NA,38430,-744,-1.9
Royaume-Uni,GBR,2017,32,37976,NA,38514,-538,-1.4
Royaume-Uni,GBR,2017,33,39069,NA,38165,904,2.4
Royaume-Uni,GBR,2017,34,39524,NA,38550,974,2.5
Royaume-Uni,GBR,2017,35,34403,NA,34060,343,1
Royaume-Uni,GBR,2017,36,39954,NA,39940,14,0
Royaume-Uni,GBR,2017,37,39608,NA,39194,414,1.1
Royaume-Uni,GBR,2017,38,40170,NA,39156,1014,2.6
Royaume-Uni,GBR,2017,39,40764,NA,39358,1406,3.6
Royaume-Uni,GBR,2017,40,41049,NA,40387,662,1.6
Royaume-Uni,GBR,2017,41,41864,NA,41362,502,1.2
Royaume-Uni,GBR,2017,42,42127,NA,41852,275,0.7
Royaume-Uni,GBR,2017,43,41126,NA,41083,43,0.1
Royaume-Uni,GBR,2017,44,42036,NA,41864,172,0.4
Royaume-Uni,GBR,2017,45,43535,NA,43781,-246,-0.6
Royaume-Uni,GBR,2017,46,43361,NA,43996,-635,-1.4
Royaume-Uni,GBR,2017,47,44741,NA,44257,484,1.1
Royaume-Uni,GBR,2017,48,44448,NA,44173,275,0.6
Royaume-Uni,GBR,2017,49,45568,NA,45321,247,0.5
Royaume-Uni,GBR,2017,50,47511,NA,45953,1558,3.4
Royaume-Uni,GBR,2017,51,52825,NA,49390,3435,7
Royaume-Uni,GBR,2018,1,54023,NA,51304,2719,5.3
Royaume-Uni,GBR,2018,2,63917,NA,55805,8112,14.5
Royaume-Uni,GBR,2018,3,60156,NA,53804,6352,11.8
Royaume-Uni,GBR,2018,4,58889,NA,52329,6560,12.5
Royaume-Uni,GBR,2018,5,55711,NA,50526,5185,10.3
Royaume-Uni,GBR,2018,6,52074,NA,49848,2226,4.5
Royaume-Uni,GBR,2018,7,51375,NA,48479,2896,6
Royaume-Uni,GBR,2018,8,50753,NA,48420,2333,4.8
Royaume-Uni,GBR,2018,9,45336,NA,46577,-1241,-2.7
Royaume-Uni,GBR,2018,10,54658,NA,48340,6318,13.1
Royaume-Uni,GBR,2018,11,53155,NA,47132,6023,12.8
Royaume-Uni,GBR,2018,12,49412,NA,44288,5124,11.6
Royaume-Uni,GBR,2018,13,41458,NA,42101,-643,-1.5
Royaume-Uni,GBR,2018,14,45275,NA,44496,779,1.8
Royaume-Uni,GBR,2018,15,51150,NA,44425,6725,15.1
Royaume-Uni,GBR,2018,16,46785,NA,42683,4102,9.6
Royaume-Uni,GBR,2018,17,43093,NA,43749,-656,-1.5
Royaume-Uni,GBR,2018,18,42547,NA,41521,1026,2.5
Royaume-Uni,GBR,2018,19,36382,NA,41005,-4623,-11.3
Royaume-Uni,GBR,2018,20,42306,NA,42621,-315,-0.7
Royaume-Uni,GBR,2018,21,40477,NA,41649,-1172,-2.8
Royaume-Uni,GBR,2018,22,34523,NA,34621,-98,-0.3
Royaume-Uni,GBR,2018,23,41774,NA,41717,57,0.1
Royaume-Uni,GBR,2018,24,39078,NA,39439,-361,-0.9
Royaume-Uni,GBR,2018,25,38942,NA,39642,-700,-1.8
Royaume-Uni,GBR,2018,26,38780,NA,39252,-472,-1.2
Royaume-Uni,GBR,2018,27,38761,NA,38604,157,0.4
Royaume-Uni,GBR,2018,28,39132,NA,39170,-38,-0.1
Royaume-Uni,GBR,2018,29,38212,NA,38548,-336,-0.9
Royaume-Uni,GBR,2018,30,38303,NA,38324,-21,-0.1
Royaume-Uni,GBR,2018,31,38491,NA,38430,61,0.2
Royaume-Uni,GBR,2018,32,39133,NA,38514,619,1.6
Royaume-Uni,GBR,2018,33,37201,NA,38165,-964,-2.5
Royaume-Uni,GBR,2018,34,37632,NA,38550,-918,-2.4
Royaume-Uni,GBR,2018,35,33267,NA,34060,-793,-2.3
Royaume-Uni,GBR,2018,36,39588,NA,39940,-352,-0.9
Royaume-Uni,GBR,2018,37,38653,NA,39194,-541,-1.4
Royaume-Uni,GBR,2018,38,39029,NA,39156,-127,-0.3
Royaume-Uni,GBR,2018,39,38583,NA,39358,-775,-2
Royaume-Uni,GBR,2018,40,39993,NA,40387,-394,-1
Royaume-Uni,GBR,2018,41,40638,NA,41362,-724,-1.8
Royaume-Uni,GBR,2018,42,41353,NA,41852,-499,-1.2
Royaume-Uni,GBR,2018,43,40213,NA,41083,-870,-2.1
Royaume-Uni,GBR,2018,44,40181,NA,41864,-1683,-4
Royaume-Uni,GBR,2018,45,42671,NA,43781,-1110,-2.5
Royaume-Uni,GBR,2018,46,42709,NA,43996,-1287,-2.9
Royaume-Uni,GBR,2018,47,41788,NA,44257,-2469,-5.6
Royaume-Uni,GBR,2018,48,42156,NA,44173,-2017,-4.6
Royaume-Uni,GBR,2018,49,43171,NA,45321,-2150,-4.7
Royaume-Uni,GBR,2018,50,44466,NA,45953,-1487,-3.2
Royaume-Uni,GBR,2018,51,46463,NA,49390,-2927,-5.9
Royaume-Uni,GBR,2019,1,45910,NA,51304,-5394,-10.5
Royaume-Uni,GBR,2019,2,53203,NA,55805,-2602,-4.7
Royaume-Uni,GBR,2019,3,50037,NA,53804,-3767,-7
Royaume-Uni,GBR,2019,4,49150,NA,52329,-3179,-6.1
Royaume-Uni,GBR,2019,5,47409,NA,50526,-3117,-6.2
Royaume-Uni,GBR,2019,6,49007,NA,49848,-841,-1.7
Royaume-Uni,GBR,2019,7,49512,NA,48479,1033,2.1
Royaume-Uni,GBR,2019,8,47517,NA,48420,-903,-1.9
Royaume-Uni,GBR,2019,9,46348,NA,46577,-229,-0.5
Royaume-Uni,GBR,2019,10,45890,NA,48340,-2450,-5.1
Royaume-Uni,GBR,2019,11,44307,NA,47132,-2825,-6
Royaume-Uni,GBR,2019,12,43658,NA,44288,-630,-1.4
Royaume-Uni,GBR,2019,13,41485,NA,42101,-616,-1.5
Royaume-Uni,GBR,2019,14,42435,NA,44496,-2061,-4.6
Royaume-Uni,GBR,2019,15,43171,NA,44425,-1254,-2.8
Royaume-Uni,GBR,2019,16,37727,NA,42683,-4956,-11.6
Royaume-Uni,GBR,2019,17,42448,NA,43749,-1301,-3
Royaume-Uni,GBR,2019,18,46900,NA,41521,5379,13
Royaume-Uni,GBR,2019,19,38247,NA,41005,-2758,-6.7
Royaume-Uni,GBR,2019,20,43192,NA,42621,571,1.3
Royaume-Uni,GBR,2019,21,43034,NA,41649,1385,3.3
Royaume-Uni,GBR,2019,22,35078,NA,34621,457,1.3
Royaume-Uni,GBR,2019,23,42505,NA,41717,788,1.9
Royaume-Uni,GBR,2019,24,39767,NA,39439,328,0.8
Royaume-Uni,GBR,2019,25,39857,NA,39642,215,0.5
Royaume-Uni,GBR,2019,26,40065,NA,39252,813,2.1
Royaume-Uni,GBR,2019,27,38101,NA,38604,-503,-1.3
Royaume-Uni,GBR,2019,28,38740,NA,39170,-430,-1.1
Royaume-Uni,GBR,2019,29,38179,NA,38548,-369,-1
Royaume-Uni,GBR,2019,30,38437,NA,38324,113,0.3
Royaume-Uni,GBR,2019,31,38981,NA,38430,551,1.4
Royaume-Uni,GBR,2019,32,38475,NA,38514,-39,-0.1
Royaume-Uni,GBR,2019,33,38276,NA,38165,111,0.3
Royaume-Uni,GBR,2019,34,37831,NA,38550,-719,-1.9
Royaume-Uni,GBR,2019,35,34835,NA,34060,775,2.3
Royaume-Uni,GBR,2019,36,40690,NA,39940,750,1.9
Royaume-Uni,GBR,2019,37,40129,NA,39194,935,2.4
Royaume-Uni,GBR,2019,38,39827,NA,39156,671,1.7
Royaume-Uni,GBR,2019,39,40210,NA,39358,852,2.2
Royaume-Uni,GBR,2019,40,41212,NA,40387,825,2
Royaume-Uni,GBR,2019,41,42118,NA,41362,756,1.8
Royaume-Uni,GBR,2019,42,42785,NA,41852,933,2.2
Royaume-Uni,GBR,2019,43,42164,NA,41083,1081,2.6
Royaume-Uni,GBR,2019,44,42721,NA,41864,857,2
Royaume-Uni,GBR,2019,45,45070,NA,43781,1289,2.9
Royaume-Uni,GBR,2019,46,44896,NA,43996,900,2
Royaume-Uni,GBR,2019,47,45898,NA,44257,1641,3.7
Royaume-Uni,GBR,2019,48,46099,NA,44173,1926,4.4
Royaume-Uni,GBR,2019,49,45395,NA,45321,74,0.2
Royaume-Uni,GBR,2019,50,47337,NA,45953,1384,3
Royaume-Uni,GBR,2019,51,49813,NA,49390,423,0.9
Royaume-Uni,GBR,2020,1,50476,0,51304,-828,-1.6
Royaume-Uni,GBR,2020,2,59121,0,55805,3316,5.9
Royaume-Uni,GBR,2020,3,54572,0,53804,768,1.4
Royaume-Uni,GBR,2020,4,49769,0,52329,-2560,-4.9
Royaume-Uni,GBR,2020,5,48686,0,50526,-1840,-3.6
Royaume-Uni,GBR,2020,6,46275,0,49848,-3573,-7.2
Royaume-Uni,GBR,2020,7,45906,0,48479,-2573,-5.3
Royaume-Uni,GBR,2020,8,45522,0,48420,-2898,-6
Royaume-Uni,GBR,2020,9,45571,0,46577,-1006,-2.2
Royaume-Uni,GBR,2020,10,45914,3,48340,-2426,-5
Royaume-Uni,GBR,2020,11,46364,62,47132,-768,-1.6
Royaume-Uni,GBR,2020,12,44726,294,44288,438,1
Royaume-Uni,GBR,2020,13,46547,1684,42101,4446,10.6
Royaume-Uni,GBR,2020,14,68912,4390,44496,24416,54.9
Royaume-Uni,GBR,2020,15,77887,6596,44425,33462,75.3
Royaume-Uni,GBR,2020,16,92840,6022,42683,50157,117.5
Royaume-Uni,GBR,2020,17,91380,5342,43749,47631,108.9
Royaume-Uni,GBR,2020,18,75035,4341,41521,33514,80.7
Royaume-Uni,GBR,2020,19,53421,3331,41005,12416,30.3
Royaume-Uni,GBR,2020,20,61100,2731,42621,18479,43.4
Royaume-Uni,GBR,2020,21,51532,2118,41649,9883,23.7
Royaume-Uni,GBR,2020,22,41570,2131,34621,6949,20.1
Royaume-Uni,GBR,2020,23,44888,1552,41717,3171,7.6
Royaume-Uni,GBR,2020,24,41945,1139,39439,2506,6.4
Hongrie,HUN,2016,1,2823,NA,2907,-84,-2.9
Hongrie,HUN,2016,2,2640,NA,2897,-257,-8.9
Hongrie,HUN,2016,3,2562,NA,2931,-369,-12.6
Hongrie,HUN,2016,4,2615,NA,3020,-405,-13.4
Hongrie,HUN,2016,5,2483,NA,3054,-571,-18.7
Hongrie,HUN,2016,6,2640,NA,2998,-358,-11.9
Hongrie,HUN,2016,7,2575,NA,2909,-334,-11.5
Hongrie,HUN,2016,8,2491,NA,2858,-367,-12.8
Hongrie,HUN,2016,9,2535,NA,2837,-302,-10.6
Hongrie,HUN,2016,10,2496,NA,2774,-278,-10
Hongrie,HUN,2016,11,2438,NA,2692,-254,-9.4
Hongrie,HUN,2016,12,2481,NA,2603,-122,-4.7
Hongrie,HUN,2016,13,2537,NA,2567,-30,-1.2
Hongrie,HUN,2016,14,2456,NA,2478,-22,-0.9
Hongrie,HUN,2016,15,2318,NA,2445,-127,-5.2
Hongrie,HUN,2016,16,2349,NA,2385,-36,-1.5
Hongrie,HUN,2016,17,2364,NA,2396,-32,-1.3
Hongrie,HUN,2016,18,2279,NA,2342,-63,-2.7
Hongrie,HUN,2016,19,2370,NA,2288,82,3.6
Hongrie,HUN,2016,20,2381,NA,2266,115,5.1
Hongrie,HUN,2016,21,2261,NA,2276,-15,-0.7
Hongrie,HUN,2016,22,2285,NA,2314,-29,-1.3
Hongrie,HUN,2016,23,2235,NA,2219,16,0.7
Hongrie,HUN,2016,24,2151,NA,2290,-139,-6.1
Hongrie,HUN,2016,25,2481,NA,2296,185,8.1
Hongrie,HUN,2016,26,2303,NA,2206,97,4.4
Hongrie,HUN,2016,27,2102,NA,2178,-76,-3.5
Hongrie,HUN,2016,28,2276,NA,2228,48,2.2
Hongrie,HUN,2016,29,2210,NA,2260,-50,-2.2
Hongrie,HUN,2016,30,2277,NA,2319,-42,-1.8
Hongrie,HUN,2016,31,2221,NA,2382,-161,-6.8
Hongrie,HUN,2016,32,2120,NA,2262,-142,-6.3
Hongrie,HUN,2016,33,2222,NA,2196,26,1.2
Hongrie,HUN,2016,34,2241,NA,2238,3,0.1
Hongrie,HUN,2016,35,2320,NA,2296,24,1
Hongrie,HUN,2016,36,2246,NA,2224,22,1
Hongrie,HUN,2016,37,2365,NA,2291,74,3.2
Hongrie,HUN,2016,38,2263,NA,2300,-37,-1.6
Hongrie,HUN,2016,39,2423,NA,2408,15,0.6
Hongrie,HUN,2016,40,2447,NA,2454,-7,-0.3
Hongrie,HUN,2016,41,2538,NA,2482,56,2.3
Hongrie,HUN,2016,42,2493,NA,2419,74,3.1
Hongrie,HUN,2016,43,2527,NA,2407,120,5
Hongrie,HUN,2016,44,2458,NA,2378,80,3.4
Hongrie,HUN,2016,45,2471,NA,2400,71,3
Hongrie,HUN,2016,46,2483,NA,2418,65,2.7
Hongrie,HUN,2016,47,2539,NA,2474,65,2.6
Hongrie,HUN,2016,48,2540,NA,2473,67,2.7
Hongrie,HUN,2016,49,2635,NA,2623,12,0.5
Hongrie,HUN,2016,50,2585,NA,2592,-7,-0.3
Hongrie,HUN,2016,51,2845,NA,2696,149,5.5
Hongrie,HUN,2016,52,2897,NA,2720,177,6.5
Hongrie,HUN,2017,1,3155,NA,2907,248,8.5
Hongrie,HUN,2017,2,3311,NA,2897,414,14.3
Hongrie,HUN,2017,3,3449,NA,2931,518,17.7
Hongrie,HUN,2017,4,3574,NA,3020,554,18.3
Hongrie,HUN,2017,5,3616,NA,3054,562,18.4
Hongrie,HUN,2017,6,3256,NA,2998,258,8.6
Hongrie,HUN,2017,7,2991,NA,2909,82,2.8
Hongrie,HUN,2017,8,2890,NA,2858,32,1.1
Hongrie,HUN,2017,9,2668,NA,2837,-169,-6
Hongrie,HUN,2017,10,2671,NA,2774,-103,-3.7
Hongrie,HUN,2017,11,2582,NA,2692,-110,-4.1
Hongrie,HUN,2017,12,2584,NA,2603,-19,-0.7
Hongrie,HUN,2017,13,2546,NA,2567,-21,-0.8
Hongrie,HUN,2017,14,2422,NA,2478,-56,-2.3
Hongrie,HUN,2017,15,2492,NA,2445,47,1.9
Hongrie,HUN,2017,16,2527,NA,2385,142,6
Hongrie,HUN,2017,17,2480,NA,2396,84,3.5
Hongrie,HUN,2017,18,2479,NA,2342,137,5.8
Hongrie,HUN,2017,19,2340,NA,2288,52,2.3
Hongrie,HUN,2017,20,2323,NA,2266,57,2.5
Hongrie,HUN,2017,21,2209,NA,2276,-67,-2.9
Hongrie,HUN,2017,22,2382,NA,2314,68,2.9
Hongrie,HUN,2017,23,2126,NA,2219,-93,-4.2
Hongrie,HUN,2017,24,2145,NA,2290,-145,-6.3
Hongrie,HUN,2017,25,2297,NA,2296,1,0
Hongrie,HUN,2017,26,2136,NA,2206,-70,-3.2
Hongrie,HUN,2017,27,2143,NA,2178,-35,-1.6
Hongrie,HUN,2017,28,2288,NA,2228,60,2.7
Hongrie,HUN,2017,29,2271,NA,2260,11,0.5
Hongrie,HUN,2017,30,2140,NA,2319,-179,-7.7
Hongrie,HUN,2017,31,2657,NA,2382,275,11.5
Hongrie,HUN,2017,32,2292,NA,2262,30,1.3
Hongrie,HUN,2017,33,2147,NA,2196,-49,-2.2
Hongrie,HUN,2017,34,2155,NA,2238,-83,-3.7
Hongrie,HUN,2017,35,2239,NA,2296,-57,-2.5
Hongrie,HUN,2017,36,2186,NA,2224,-38,-1.7
Hongrie,HUN,2017,37,2290,NA,2291,-1,-0
Hongrie,HUN,2017,38,2312,NA,2300,12,0.5
Hongrie,HUN,2017,39,2351,NA,2408,-57,-2.4
Hongrie,HUN,2017,40,2428,NA,2454,-26,-1.1
Hongrie,HUN,2017,41,2496,NA,2482,14,0.6
Hongrie,HUN,2017,42,2357,NA,2419,-62,-2.6
Hongrie,HUN,2017,43,2338,NA,2407,-69,-2.9
Hongrie,HUN,2017,44,2397,NA,2378,19,0.8
Hongrie,HUN,2017,45,2324,NA,2400,-76,-3.2
Hongrie,HUN,2017,46,2423,NA,2418,5,0.2
Hongrie,HUN,2017,47,2503,NA,2474,29,1.2
Hongrie,HUN,2017,48,2437,NA,2473,-36,-1.5
Hongrie,HUN,2017,49,2655,NA,2623,32,1.2
Hongrie,HUN,2017,50,2580,NA,2592,-12,-0.5
Hongrie,HUN,2017,51,2605,NA,2696,-91,-3.4
Hongrie,HUN,2017,52,2628,NA,2720,-92,-3.4
Hongrie,HUN,2018,1,2595,NA,2907,-312,-10.7
Hongrie,HUN,2018,2,2546,NA,2897,-351,-12.1
Hongrie,HUN,2018,3,2675,NA,2931,-256,-8.7
Hongrie,HUN,2018,4,2655,NA,3020,-365,-12.1
Hongrie,HUN,2018,5,2731,NA,3054,-323,-10.6
Hongrie,HUN,2018,6,2833,NA,2998,-165,-5.5
Hongrie,HUN,2018,7,3037,NA,2909,128,4.4
Hongrie,HUN,2018,8,3161,NA,2858,303,10.6
Hongrie,HUN,2018,9,3237,NA,2837,400,14.1
Hongrie,HUN,2018,10,3218,NA,2774,444,16
Hongrie,HUN,2018,11,3016,NA,2692,324,12
Hongrie,HUN,2018,12,2878,NA,2603,275,10.6
Hongrie,HUN,2018,13,2774,NA,2567,207,8.1
Hongrie,HUN,2018,14,2622,NA,2478,144,5.8
Hongrie,HUN,2018,15,2576,NA,2445,131,5.4
Hongrie,HUN,2018,16,2336,NA,2385,-49,-2.1
Hongrie,HUN,2018,17,2300,NA,2396,-96,-4
Hongrie,HUN,2018,18,2294,NA,2342,-48,-2
Hongrie,HUN,2018,19,2160,NA,2288,-128,-5.6
Hongrie,HUN,2018,20,2154,NA,2266,-112,-4.9
Hongrie,HUN,2018,21,2352,NA,2276,76,3.3
Hongrie,HUN,2018,22,2393,NA,2314,79,3.4
Hongrie,HUN,2018,23,2228,NA,2219,9,0.4
Hongrie,HUN,2018,24,2243,NA,2290,-47,-2.1
Hongrie,HUN,2018,25,2188,NA,2296,-108,-4.7
Hongrie,HUN,2018,26,2140,NA,2206,-66,-3
Hongrie,HUN,2018,27,2225,NA,2178,47,2.2
Hongrie,HUN,2018,28,2285,NA,2228,57,2.6
Hongrie,HUN,2018,29,2265,NA,2260,5,0.2
Hongrie,HUN,2018,30,2389,NA,2319,70,3
Hongrie,HUN,2018,31,2479,NA,2382,97,4.1
Hongrie,HUN,2018,32,2419,NA,2262,157,6.9
Hongrie,HUN,2018,33,2199,NA,2196,3,0.1
Hongrie,HUN,2018,34,2323,NA,2238,85,3.8
Hongrie,HUN,2018,35,2254,NA,2296,-42,-1.8
Hongrie,HUN,2018,36,2267,NA,2224,43,1.9
Hongrie,HUN,2018,37,2356,NA,2291,65,2.8
Hongrie,HUN,2018,38,2385,NA,2300,85,3.7
Hongrie,HUN,2018,39,2362,NA,2408,-46,-1.9
Hongrie,HUN,2018,40,2498,NA,2454,44,1.8
Hongrie,HUN,2018,41,2512,NA,2482,30,1.2
Hongrie,HUN,2018,42,2432,NA,2419,13,0.5
Hongrie,HUN,2018,43,2409,NA,2407,2,0.1
Hongrie,HUN,2018,44,2361,NA,2378,-17,-0.7
Hongrie,HUN,2018,45,2362,NA,2400,-38,-1.6
Hongrie,HUN,2018,46,2408,NA,2418,-10,-0.4
Hongrie,HUN,2018,47,2555,NA,2474,81,3.3
Hongrie,HUN,2018,48,2559,NA,2473,86,3.5
Hongrie,HUN,2018,49,2644,NA,2623,21,0.8
Hongrie,HUN,2018,50,2677,NA,2592,85,3.3
Hongrie,HUN,2018,51,2797,NA,2696,101,3.7
Hongrie,HUN,2018,52,2860,NA,2720,140,5.1
Hongrie,HUN,2019,1,3054,NA,2907,147,5.1
Hongrie,HUN,2019,2,3090,NA,2897,193,6.7
Hongrie,HUN,2019,3,3037,NA,2931,106,3.6
Hongrie,HUN,2019,4,3234,NA,3020,214,7.1
Hongrie,HUN,2019,5,3384,NA,3054,330,10.8
Hongrie,HUN,2019,6,3263,NA,2998,265,8.8
Hongrie,HUN,2019,7,3034,NA,2909,125,4.3
Hongrie,HUN,2019,8,2888,NA,2858,30,1
Hongrie,HUN,2019,9,2909,NA,2837,72,2.5
Hongrie,HUN,2019,10,2713,NA,2774,-61,-2.2
Hongrie,HUN,2019,11,2733,NA,2692,41,1.5
Hongrie,HUN,2019,12,2469,NA,2603,-134,-5.1
Hongrie,HUN,2019,13,2411,NA,2567,-156,-6.1
Hongrie,HUN,2019,14,2414,NA,2478,-64,-2.6
Hongrie,HUN,2019,15,2393,NA,2445,-52,-2.1
Hongrie,HUN,2019,16,2327,NA,2385,-58,-2.4
Hongrie,HUN,2019,17,2442,NA,2396,46,1.9
Hongrie,HUN,2019,18,2316,NA,2342,-26,-1.1
Hongrie,HUN,2019,19,2283,NA,2288,-5,-0.2
Hongrie,HUN,2019,20,2208,NA,2266,-58,-2.6
Hongrie,HUN,2019,21,2283,NA,2276,7,0.3
Hongrie,HUN,2019,22,2196,NA,2314,-118,-5.1
Hongrie,HUN,2019,23,2288,NA,2219,69,3.1
Hongrie,HUN,2019,24,2623,NA,2290,333,14.5
Hongrie,HUN,2019,25,2217,NA,2296,-79,-3.4
Hongrie,HUN,2019,26,2247,NA,2206,41,1.9
Hongrie,HUN,2019,27,2242,NA,2178,64,2.9
Hongrie,HUN,2019,28,2065,NA,2228,-163,-7.3
Hongrie,HUN,2019,29,2292,NA,2260,32,1.4
Hongrie,HUN,2019,30,2471,NA,2319,152,6.6
Hongrie,HUN,2019,31,2170,NA,2382,-212,-8.9
Hongrie,HUN,2019,32,2215,NA,2262,-47,-2.1
Hongrie,HUN,2019,33,2218,NA,2196,22,1
Hongrie,HUN,2019,34,2235,NA,2238,-3,-0.1
Hongrie,HUN,2019,35,2373,NA,2296,77,3.4
Hongrie,HUN,2019,36,2199,NA,2224,-25,-1.1
Hongrie,HUN,2019,37,2154,NA,2291,-137,-6
Hongrie,HUN,2019,38,2241,NA,2300,-59,-2.6
Hongrie,HUN,2019,39,2494,NA,2408,86,3.6
Hongrie,HUN,2019,40,2442,NA,2454,-12,-0.5
Hongrie,HUN,2019,41,2382,NA,2482,-100,-4
Hongrie,HUN,2019,42,2394,NA,2419,-25,-1
Hongrie,HUN,2019,43,2355,NA,2407,-52,-2.2
Hongrie,HUN,2019,44,2297,NA,2378,-81,-3.4
Hongrie,HUN,2019,45,2443,NA,2400,43,1.8
Hongrie,HUN,2019,46,2358,NA,2418,-60,-2.5
Hongrie,HUN,2019,47,2301,NA,2474,-173,-7
Hongrie,HUN,2019,48,2355,NA,2473,-118,-4.8
Hongrie,HUN,2019,49,2558,NA,2623,-65,-2.5
Hongrie,HUN,2019,50,2526,NA,2592,-66,-2.5
Hongrie,HUN,2019,51,2536,NA,2696,-160,-5.9
Hongrie,HUN,2019,52,2494,NA,2720,-226,-8.3
Hongrie,HUN,2020,1,2609,NA,2907,-298,-10.3
Hongrie,HUN,2020,2,2582,NA,2897,-315,-10.9
Hongrie,HUN,2020,3,2582,NA,2931,-349,-11.9
Hongrie,HUN,2020,4,2718,NA,3020,-302,-10
Hongrie,HUN,2020,5,2799,NA,3054,-255,-8.3
Hongrie,HUN,2020,6,2633,NA,2998,-365,-12.2
Hongrie,HUN,2020,7,2750,NA,2909,-159,-5.5
Hongrie,HUN,2020,8,2584,NA,2858,-274,-9.6
Hongrie,HUN,2020,9,2779,NA,2837,-58,-2
Hongrie,HUN,2020,10,2604,0,2774,-170,-6.1
Hongrie,HUN,2020,11,2576,1,2692,-116,-4.3
Hongrie,HUN,2020,12,2794,7,2603,191,7.3
Hongrie,HUN,2020,13,2585,8,2567,18,0.7
Hongrie,HUN,2020,14,2518,31,2478,40,1.6
Hongrie,HUN,2020,15,2568,75,2445,123,5
Hongrie,HUN,2020,16,2501,91,2385,116,4.9
Hongrie,HUN,2020,17,2346,78,2396,-50,-2.1
Hongrie,HUN,2020,18,2220,72,2342,-122,-5.2
Hongrie,HUN,2020,19,2251,62,2288,-37,-1.6
Hongrie,HUN,2020,20,2259,42,2266,-7,-0.3
Hongrie,HUN,2020,21,1988,32,2276,-288,-12.7
Islande,ISL,2016,1,44,NA,45,-1,-2.2
Islande,ISL,2016,2,56,NA,49,7,14.3
Islande,ISL,2016,3,51,NA,44,7,15.9
Islande,ISL,2016,4,35,NA,44,-9,-20.5
Islande,ISL,2016,5,46,NA,46,0,0
Islande,ISL,2016,6,45,NA,46,-1,-2.2
Islande,ISL,2016,7,39,NA,46,-7,-15.2
Islande,ISL,2016,8,40,NA,46,-6,-13
Islande,ISL,2016,9,39,NA,43,-4,-9.3
Islande,ISL,2016,10,51,NA,45,6,13.3
Islande,ISL,2016,11,44,NA,45,-1,-2.2
Islande,ISL,2016,12,42,NA,41,1,2.4
Islande,ISL,2016,13,43,NA,48,-5,-10.4
Islande,ISL,2016,14,48,NA,44,4,9.1
Islande,ISL,2016,15,47,NA,46,1,2.2
Islande,ISL,2016,16,53,NA,49,4,8.2
Islande,ISL,2016,17,49,NA,45,4,8.9
Islande,ISL,2016,18,37,NA,40,-3,-7.5
Islande,ISL,2016,19,39,NA,43,-4,-9.3
Islande,ISL,2016,20,34,NA,40,-6,-15
Islande,ISL,2016,21,40,NA,42,-2,-4.8
Islande,ISL,2016,22,45,NA,44,1,2.3
Islande,ISL,2016,23,45,NA,47,-2,-4.3
Islande,ISL,2016,24,40,NA,39,1,2.6
Islande,ISL,2016,25,33,NA,39,-6,-15.4
Islande,ISL,2016,26,48,NA,51,-3,-5.9
Islande,ISL,2016,27,46,NA,43,3,7
Islande,ISL,2016,28,41,NA,39,2,5.1
Islande,ISL,2016,29,54,NA,41,13,31.7
Islande,ISL,2016,30,43,NA,42,1,2.4
Islande,ISL,2016,31,33,NA,34,-1,-2.9
Islande,ISL,2016,32,43,NA,40,3,7.5
Islande,ISL,2016,33,44,NA,36,8,22.2
Islande,ISL,2016,34,37,NA,43,-6,-14
Islande,ISL,2016,35,42,NA,38,4,10.5
Islande,ISL,2016,36,37,NA,37,0,0
Islande,ISL,2016,37,51,NA,44,7,15.9
Islande,ISL,2016,38,57,NA,42,15,35.7
Islande,ISL,2016,39,55,NA,51,4,7.8
Islande,ISL,2016,40,47,NA,45,2,4.4
Islande,ISL,2016,41,41,NA,46,-5,-10.9
Islande,ISL,2016,42,50,NA,43,7,16.3
Islande,ISL,2016,43,48,NA,44,4,9.1
Islande,ISL,2016,44,40,NA,42,-2,-4.8
Islande,ISL,2016,45,48,NA,40,8,20
Islande,ISL,2016,46,49,NA,48,1,2.1
Islande,ISL,2016,47,38,NA,44,-6,-13.6
Islande,ISL,2016,48,30,NA,42,-12,-28.6
Islande,ISL,2016,49,43,NA,44,-1,-2.3
Islande,ISL,2016,50,48,NA,43,5,11.6
Islande,ISL,2016,51,52,NA,44,8,18.2
Islande,ISL,2016,52,45,NA,44,1,2.3
Islande,ISL,2017,1,35,NA,45,-10,-22.2
Islande,ISL,2017,2,53,NA,49,4,8.2
Islande,ISL,2017,3,46,NA,44,2,4.5
Islande,ISL,2017,4,53,NA,44,9,20.5
Islande,ISL,2017,5,48,NA,46,2,4.3
Islande,ISL,2017,6,55,NA,46,9,19.6
Islande,ISL,2017,7,56,NA,46,10,21.7
Islande,ISL,2017,8,46,NA,46,0,0
Islande,ISL,2017,9,35,NA,43,-8,-18.6
Islande,ISL,2017,10,40,NA,45,-5,-11.1
Islande,ISL,2017,11,42,NA,45,-3,-6.7
Islande,ISL,2017,12,48,NA,41,7,17.1
Islande,ISL,2017,13,48,NA,48,0,0
Islande,ISL,2017,14,35,NA,44,-9,-20.5
Islande,ISL,2017,15,43,NA,46,-3,-6.5
Islande,ISL,2017,16,51,NA,49,2,4.1
Islande,ISL,2017,17,38,NA,45,-7,-15.6
Islande,ISL,2017,18,46,NA,40,6,15
Islande,ISL,2017,19,45,NA,43,2,4.7
Islande,ISL,2017,20,40,NA,40,0,0
Islande,ISL,2017,21,41,NA,42,-1,-2.4
Islande,ISL,2017,22,41,NA,44,-3,-6.8
Islande,ISL,2017,23,44,NA,47,-3,-6.4
Islande,ISL,2017,24,40,NA,39,1,2.6
Islande,ISL,2017,25,47,NA,39,8,20.5
Islande,ISL,2017,26,43,NA,51,-8,-15.7
Islande,ISL,2017,27,47,NA,43,4,9.3
Islande,ISL,2017,28,35,NA,39,-4,-10.3
Islande,ISL,2017,29,46,NA,41,5,12.2
Islande,ISL,2017,30,40,NA,42,-2,-4.8
Islande,ISL,2017,31,31,NA,34,-3,-8.8
Islande,ISL,2017,32,38,NA,40,-2,-5
Islande,ISL,2017,33,40,NA,36,4,11.1
Islande,ISL,2017,34,44,NA,43,1,2.3
Islande,ISL,2017,35,40,NA,38,2,5.3
Islande,ISL,2017,36,36,NA,37,-1,-2.7
Islande,ISL,2017,37,45,NA,44,1,2.3
Islande,ISL,2017,38,35,NA,42,-7,-16.7
Islande,ISL,2017,39,47,NA,51,-4,-7.8
Islande,ISL,2017,40,35,NA,45,-10,-22.2
Islande,ISL,2017,41,45,NA,46,-1,-2.2
Islande,ISL,2017,42,47,NA,43,4,9.3
Islande,ISL,2017,43,38,NA,44,-6,-13.6
Islande,ISL,2017,44,39,NA,42,-3,-7.1
Islande,ISL,2017,45,37,NA,40,-3,-7.5
Islande,ISL,2017,46,51,NA,48,3,6.2
Islande,ISL,2017,47,47,NA,44,3,6.8
Islande,ISL,2017,48,47,NA,42,5,11.9
Islande,ISL,2017,49,43,NA,44,-1,-2.3
Islande,ISL,2017,50,36,NA,43,-7,-16.3
Islande,ISL,2017,51,44,NA,44,0,0
Islande,ISL,2017,52,37,NA,44,-7,-15.9
Islande,ISL,2018,1,62,NA,45,17,37.8
Islande,ISL,2018,2,47,NA,49,-2,-4.1
Islande,ISL,2018,3,41,NA,44,-3,-6.8
Islande,ISL,2018,4,50,NA,44,6,13.6
Islande,ISL,2018,5,47,NA,46,1,2.2
Islande,ISL,2018,6,46,NA,46,0,0
Islande,ISL,2018,7,44,NA,46,-2,-4.3
Islande,ISL,2018,8,57,NA,46,11,23.9
Islande,ISL,2018,9,50,NA,43,7,16.3
Islande,ISL,2018,10,43,NA,45,-2,-4.4
Islande,ISL,2018,11,37,NA,45,-8,-17.8
Islande,ISL,2018,12,36,NA,41,-5,-12.2
Islande,ISL,2018,13,55,NA,48,7,14.6
Islande,ISL,2018,14,55,NA,44,11,25
Islande,ISL,2018,15,51,NA,46,5,10.9
Islande,ISL,2018,16,45,NA,49,-4,-8.2
Islande,ISL,2018,17,41,NA,45,-4,-8.9
Islande,ISL,2018,18,32,NA,40,-8,-20
Islande,ISL,2018,19,43,NA,43,0,0
Islande,ISL,2018,20,38,NA,40,-2,-5
Islande,ISL,2018,21,51,NA,42,9,21.4
Islande,ISL,2018,22,50,NA,44,6,13.6
Islande,ISL,2018,23,54,NA,47,7,14.9
Islande,ISL,2018,24,35,NA,39,-4,-10.3
Islande,ISL,2018,25,36,NA,39,-3,-7.7
Islande,ISL,2018,26,52,NA,51,1,2
Islande,ISL,2018,27,40,NA,43,-3,-7
Islande,ISL,2018,28,38,NA,39,-1,-2.6
Islande,ISL,2018,29,33,NA,41,-8,-19.5
Islande,ISL,2018,30,30,NA,42,-12,-28.6
Islande,ISL,2018,31,41,NA,34,7,20.6
Islande,ISL,2018,32,45,NA,40,5,12.5
Islande,ISL,2018,33,25,NA,36,-11,-30.6
Islande,ISL,2018,34,38,NA,43,-5,-11.6
Islande,ISL,2018,35,36,NA,38,-2,-5.3
Islande,ISL,2018,36,41,NA,37,4,10.8
Islande,ISL,2018,37,45,NA,44,1,2.3
Islande,ISL,2018,38,33,NA,42,-9,-21.4
Islande,ISL,2018,39,50,NA,51,-1,-2
Islande,ISL,2018,40,42,NA,45,-3,-6.7
Islande,ISL,2018,41,51,NA,46,5,10.9
Islande,ISL,2018,42,37,NA,43,-6,-14
Islande,ISL,2018,43,54,NA,44,10,22.7
Islande,ISL,2018,44,40,NA,42,-2,-4.8
Islande,ISL,2018,45,39,NA,40,-1,-2.5
Islande,ISL,2018,46,45,NA,48,-3,-6.2
Islande,ISL,2018,47,42,NA,44,-2,-4.5
Islande,ISL,2018,48,32,NA,42,-10,-23.8
Islande,ISL,2018,49,43,NA,44,-1,-2.3
Islande,ISL,2018,50,41,NA,43,-2,-4.7
Islande,ISL,2018,51,42,NA,44,-2,-4.5
Islande,ISL,2018,52,46,NA,44,2,4.5
Islande,ISL,2019,1,39,NA,45,-6,-13.3
Islande,ISL,2019,2,41,NA,49,-8,-16.3
Islande,ISL,2019,3,40,NA,44,-4,-9.1
Islande,ISL,2019,4,37,NA,44,-7,-15.9
Islande,ISL,2019,5,43,NA,46,-3,-6.5
Islande,ISL,2019,6,36,NA,46,-10,-21.7
Islande,ISL,2019,7,47,NA,46,1,2.2
Islande,ISL,2019,8,41,NA,46,-5,-10.9
Islande,ISL,2019,9,47,NA,43,4,9.3
Islande,ISL,2019,10,47,NA,45,2,4.4
Islande,ISL,2019,11,57,NA,45,12,26.7
Islande,ISL,2019,12,37,NA,41,-4,-9.8
Islande,ISL,2019,13,48,NA,48,0,0
Islande,ISL,2019,14,38,NA,44,-6,-13.6
Islande,ISL,2019,15,42,NA,46,-4,-8.7
Islande,ISL,2019,16,47,NA,49,-2,-4.1
Islande,ISL,2019,17,53,NA,45,8,17.8
Islande,ISL,2019,18,45,NA,40,5,12.5
Islande,ISL,2019,19,44,NA,43,1,2.3
Islande,ISL,2019,20,46,NA,40,6,15
Islande,ISL,2019,21,36,NA,42,-6,-14.3
Islande,ISL,2019,22,38,NA,44,-6,-13.6
Islande,ISL,2019,23,45,NA,47,-2,-4.3
Islande,ISL,2019,24,42,NA,39,3,7.7
Islande,ISL,2019,25,39,NA,39,0,0
Islande,ISL,2019,26,60,NA,51,9,17.6
Islande,ISL,2019,27,40,NA,43,-3,-7
Islande,ISL,2019,28,42,NA,39,3,7.7
Islande,ISL,2019,29,30,NA,41,-11,-26.8
Islande,ISL,2019,30,56,NA,42,14,33.3
Islande,ISL,2019,31,33,NA,34,-1,-2.9
Islande,ISL,2019,32,36,NA,40,-4,-10
Islande,ISL,2019,33,37,NA,36,1,2.8
Islande,ISL,2019,34,53,NA,43,10,23.3
Islande,ISL,2019,35,36,NA,38,-2,-5.3
Islande,ISL,2019,36,34,NA,37,-3,-8.1
Islande,ISL,2019,37,33,NA,44,-11,-25
Islande,ISL,2019,38,45,NA,42,3,7.1
Islande,ISL,2019,39,53,NA,51,2,3.9
Islande,ISL,2019,40,56,NA,45,11,24.4
Islande,ISL,2019,41,48,NA,46,2,4.3
Islande,ISL,2019,42,38,NA,43,-5,-11.6
Islande,ISL,2019,43,38,NA,44,-6,-13.6
Islande,ISL,2019,44,50,NA,42,8,19
Islande,ISL,2019,45,38,NA,40,-2,-5
Islande,ISL,2019,46,45,NA,48,-3,-6.2
Islande,ISL,2019,47,51,NA,44,7,15.9
Islande,ISL,2019,48,58,NA,42,16,38.1
Islande,ISL,2019,49,45,NA,44,1,2.3
Islande,ISL,2019,50,46,NA,43,3,7
Islande,ISL,2019,51,36,NA,44,-8,-18.2
Islande,ISL,2019,52,49,NA,44,5,11.4
Islande,ISL,2020,1,57,0,45,12,26.7
Islande,ISL,2020,2,55,0,49,6,12.2
Islande,ISL,2020,3,52,0,44,8,18.2
Islande,ISL,2020,4,55,0,44,11,25
Islande,ISL,2020,5,39,0,46,-7,-15.2
Islande,ISL,2020,6,47,0,46,1,2.2
Islande,ISL,2020,7,49,0,46,3,6.5
Islande,ISL,2020,8,48,0,46,2,4.3
Islande,ISL,2020,9,43,0,43,0,0
Islande,ISL,2020,10,49,0,45,4,8.9
Islande,ISL,2020,11,43,0,45,-2,-4.4
Islande,ISL,2020,12,38,2,41,-3,-7.3
Islande,ISL,2020,13,42,0,48,-6,-12.5
Islande,ISL,2020,14,50,4,44,6,13.6
Islande,ISL,2020,15,47,2,46,1,2.2
Islande,ISL,2020,16,60,2,49,11,22.4
Islande,ISL,2020,17,35,0,45,-10,-22.2
Islande,ISL,2020,18,43,0,40,3,7.5
Islande,ISL,2020,19,35,0,43,-8,-18.6
Islande,ISL,2020,20,41,0,40,1,2.5
Islande,ISL,2020,21,50,0,42,8,19
Islande,ISL,2020,22,48,0,44,4,9.1
Islande,ISL,2020,23,34,0,47,-13,-27.7
Islande,ISL,2020,24,33,0,39,-6,-15.4
Italie,ITA,2016,1,12637,NA,14455,-1818,-12.6
Italie,ITA,2016,2,12180,NA,14665,-2485,-16.9
Italie,ITA,2016,3,12594,NA,14464,-1870,-12.9
Italie,ITA,2016,4,12483,NA,13982,-1499,-10.7
Italie,ITA,2016,5,12128,NA,13778,-1650,-12
Italie,ITA,2016,6,12282,NA,13132,-850,-6.5
Italie,ITA,2016,7,11826,NA,12950,-1124,-8.7
Italie,ITA,2016,8,11860,NA,12744,-884,-6.9
Italie,ITA,2016,9,11912,NA,12792,-880,-6.9
Italie,ITA,2016,10,11950,NA,12534,-584,-4.7
Italie,ITA,2016,11,11978,NA,12185,-207,-1.7
Italie,ITA,2016,12,11700,NA,11695,5,0
Italie,ITA,2016,13,11897,NA,11714,183,1.6
Italie,ITA,2016,14,11477,NA,11510,-33,-0.3
Italie,ITA,2016,15,11018,NA,11241,-223,-2
Italie,ITA,2016,16,10848,NA,11040,-192,-1.7
Italie,ITA,2016,17,10670,NA,10974,-304,-2.8
Italie,ITA,2016,18,10880,NA,10827,53,0.5
Italie,ITA,2016,19,10644,NA,10756,-112,-1
Italie,ITA,2016,20,10276,NA,10557,-281,-2.7
Italie,ITA,2016,21,10812,NA,10790,22,0.2
Italie,ITA,2016,22,10085,NA,10534,-449,-4.3
Italie,ITA,2016,23,10348,NA,10576,-228,-2.2
Italie,ITA,2016,24,10069,NA,10602,-533,-5
Italie,ITA,2016,25,10747,NA,10674,73,0.7
Italie,ITA,2016,26,10545,NA,10692,-147,-1.4
Italie,ITA,2016,27,10575,NA,10763,-188,-1.7
Italie,ITA,2016,28,10595,NA,10693,-98,-0.9
Italie,ITA,2016,29,10492,NA,10416,76,0.7
Italie,ITA,2016,30,10325,NA,10601,-276,-2.6
Italie,ITA,2016,31,10253,NA,11059,-806,-7.3
Italie,ITA,2016,32,9938,NA,11336,-1398,-12.3
Italie,ITA,2016,33,10406,NA,10588,-182,-1.7
Italie,ITA,2016,34,10526,NA,10416,110,1.1
Italie,ITA,2016,35,10084,NA,10229,-145,-1.4
Italie,ITA,2016,36,9825,NA,9967,-142,-1.4
Italie,ITA,2016,37,9898,NA,10166,-268,-2.6
Italie,ITA,2016,38,9704,NA,10170,-466,-4.6
Italie,ITA,2016,39,10422,NA,10401,21,0.2
Italie,ITA,2016,40,10407,NA,10582,-175,-1.7
Italie,ITA,2016,41,11558,NA,11119,439,3.9
Italie,ITA,2016,42,11296,NA,11010,286,2.6
Italie,ITA,2016,43,11078,NA,11110,-32,-0.3
Italie,ITA,2016,44,11026,NA,10839,187,1.7
Italie,ITA,2016,45,11186,NA,11172,14,0.1
Italie,ITA,2016,46,11700,NA,11445,255,2.2
Italie,ITA,2016,47,11362,NA,11507,-145,-1.3
Italie,ITA,2016,48,11398,NA,11527,-129,-1.1
Italie,ITA,2016,49,11704,NA,11742,-38,-0.3
Italie,ITA,2016,50,12433,NA,12258,175,1.4
Italie,ITA,2016,51,13929,NA,12825,1104,8.6
Italie,ITA,2016,52,15448,NA,13437,2011,15
Italie,ITA,2017,1,16889,NA,14455,2434,16.8
Italie,ITA,2017,2,17722,NA,14665,3057,20.8
Italie,ITA,2017,3,16695,NA,14464,2231,15.4
Italie,ITA,2017,4,15345,NA,13982,1363,9.7
Italie,ITA,2017,5,14710,NA,13778,932,6.8
Italie,ITA,2017,6,13122,NA,13132,-10,-0.1
Italie,ITA,2017,7,12882,NA,12950,-68,-0.5
Italie,ITA,2017,8,12385,NA,12744,-359,-2.8
Italie,ITA,2017,9,12203,NA,12792,-589,-4.6
Italie,ITA,2017,10,12032,NA,12534,-502,-4
Italie,ITA,2017,11,11903,NA,12185,-282,-2.3
Italie,ITA,2017,12,11751,NA,11695,56,0.5
Italie,ITA,2017,13,11460,NA,11714,-254,-2.2
Italie,ITA,2017,14,11084,NA,11510,-426,-3.7
Italie,ITA,2017,15,11328,NA,11241,87,0.8
Italie,ITA,2017,16,10831,NA,11040,-209,-1.9
Italie,ITA,2017,17,11207,NA,10974,233,2.1
Italie,ITA,2017,18,11338,NA,10827,511,4.7
Italie,ITA,2017,19,11075,NA,10756,319,3
Italie,ITA,2017,20,10964,NA,10557,407,3.9
Italie,ITA,2017,21,10811,NA,10790,21,0.2
Italie,ITA,2017,22,10831,NA,10534,297,2.8
Italie,ITA,2017,23,10168,NA,10576,-408,-3.9
Italie,ITA,2017,24,10782,NA,10602,180,1.7
Italie,ITA,2017,25,10962,NA,10674,288,2.7
Italie,ITA,2017,26,10403,NA,10692,-289,-2.7
Italie,ITA,2017,27,10427,NA,10763,-336,-3.1
Italie,ITA,2017,28,10873,NA,10693,180,1.7
Italie,ITA,2017,29,10425,NA,10416,9,0.1
Italie,ITA,2017,30,10378,NA,10601,-223,-2.1
Italie,ITA,2017,31,12145,NA,11059,1086,9.8
Italie,ITA,2017,32,13046,NA,11336,1710,15.1
Italie,ITA,2017,33,10912,NA,10588,324,3.1
Italie,ITA,2017,34,10251,NA,10416,-165,-1.6
Italie,ITA,2017,35,10421,NA,10229,192,1.9
Italie,ITA,2017,36,9873,NA,9967,-94,-0.9
Italie,ITA,2017,37,10060,NA,10166,-106,-1
Italie,ITA,2017,38,10277,NA,10170,107,1.1
Italie,ITA,2017,39,10721,NA,10401,320,3.1
Italie,ITA,2017,40,10869,NA,10582,287,2.7
Italie,ITA,2017,41,11271,NA,11119,152,1.4
Italie,ITA,2017,42,11061,NA,11010,51,0.5
Italie,ITA,2017,43,11158,NA,11110,48,0.4
Italie,ITA,2017,44,10992,NA,10839,153,1.4
Italie,ITA,2017,45,11455,NA,11172,283,2.5
Italie,ITA,2017,46,11664,NA,11445,219,1.9
Italie,ITA,2017,47,11666,NA,11507,159,1.4
Italie,ITA,2017,48,11785,NA,11527,258,2.2
Italie,ITA,2017,49,12190,NA,11742,448,3.8
Italie,ITA,2017,50,12672,NA,12258,414,3.4
Italie,ITA,2017,51,12651,NA,12825,-174,-1.4
Italie,ITA,2017,52,14043,NA,13437,606,4.5
Italie,ITA,2018,1,15164,NA,14455,709,4.9
Italie,ITA,2018,2,14886,NA,14665,221,1.5
Italie,ITA,2018,3,14194,NA,14464,-270,-1.9
Italie,ITA,2018,4,13770,NA,13982,-212,-1.5
Italie,ITA,2018,5,13570,NA,13778,-208,-1.5
Italie,ITA,2018,6,12935,NA,13132,-197,-1.5
Italie,ITA,2018,7,13051,NA,12950,101,0.8
Italie,ITA,2018,8,13036,NA,12744,292,2.3
Italie,ITA,2018,9,13413,NA,12792,621,4.9
Italie,ITA,2018,10,13238,NA,12534,704,5.6
Italie,ITA,2018,11,12441,NA,12185,256,2.1
Italie,ITA,2018,12,11595,NA,11695,-100,-0.9
Italie,ITA,2018,13,11903,NA,11714,189,1.6
Italie,ITA,2018,14,11601,NA,11510,91,0.8
Italie,ITA,2018,15,11336,NA,11241,95,0.8
Italie,ITA,2018,16,11121,NA,11040,81,0.7
Italie,ITA,2018,17,10935,NA,10974,-39,-0.4
Italie,ITA,2018,18,10324,NA,10827,-503,-4.6
Italie,ITA,2018,19,10324,NA,10756,-432,-4
Italie,ITA,2018,20,10141,NA,10557,-416,-3.9
Italie,ITA,2018,21,10632,NA,10790,-158,-1.5
Italie,ITA,2018,22,10594,NA,10534,60,0.6
Italie,ITA,2018,23,10302,NA,10576,-274,-2.6
Italie,ITA,2018,24,10365,NA,10602,-237,-2.2
Italie,ITA,2018,25,10328,NA,10674,-346,-3.2
Italie,ITA,2018,26,9919,NA,10692,-773,-7.2
Italie,ITA,2018,27,10460,NA,10763,-303,-2.8
Italie,ITA,2018,28,10425,NA,10693,-268,-2.5
Italie,ITA,2018,29,10445,NA,10416,29,0.3
Italie,ITA,2018,30,10419,NA,10601,-182,-1.7
Italie,ITA,2018,31,11546,NA,11059,487,4.4
Italie,ITA,2018,32,11713,NA,11336,377,3.3
Italie,ITA,2018,33,10511,NA,10588,-77,-0.7
Italie,ITA,2018,34,10543,NA,10416,127,1.2
Italie,ITA,2018,35,10171,NA,10229,-58,-0.6
Italie,ITA,2018,36,10357,NA,9967,390,3.9
Italie,ITA,2018,37,10384,NA,10166,218,2.1
Italie,ITA,2018,38,10458,NA,10170,288,2.8
Italie,ITA,2018,39,10188,NA,10401,-213,-2
Italie,ITA,2018,40,10771,NA,10582,189,1.8
Italie,ITA,2018,41,10909,NA,11119,-210,-1.9
Italie,ITA,2018,42,10924,NA,11010,-86,-0.8
Italie,ITA,2018,43,11146,NA,11110,36,0.3
Italie,ITA,2018,44,10791,NA,10839,-48,-0.4
Italie,ITA,2018,45,11048,NA,11172,-124,-1.1
Italie,ITA,2018,46,11058,NA,11445,-387,-3.4
Italie,ITA,2018,47,11737,NA,11507,230,2
Italie,ITA,2018,48,11639,NA,11527,112,1
Italie,ITA,2018,49,11918,NA,11742,176,1.5
Italie,ITA,2018,50,11995,NA,12258,-263,-2.1
Italie,ITA,2018,51,12505,NA,12825,-320,-2.5
Italie,ITA,2018,52,12605,NA,13437,-832,-6.2
Italie,ITA,2019,1,13131,NA,14455,-1324,-9.2
Italie,ITA,2019,2,13872,NA,14665,-793,-5.4
Italie,ITA,2019,3,14371,NA,14464,-93,-0.6
Italie,ITA,2019,4,14329,NA,13982,347,2.5
Italie,ITA,2019,5,14704,NA,13778,926,6.7
Italie,ITA,2019,6,14188,NA,13132,1056,8
Italie,ITA,2019,7,14042,NA,12950,1092,8.4
Italie,ITA,2019,8,13696,NA,12744,952,7.5
Italie,ITA,2019,9,13641,NA,12792,849,6.6
Italie,ITA,2019,10,12915,NA,12534,381,3
Italie,ITA,2019,11,12419,NA,12185,234,1.9
Italie,ITA,2019,12,11734,NA,11695,39,0.3
Italie,ITA,2019,13,11595,NA,11714,-119,-1
Italie,ITA,2019,14,11877,NA,11510,367,3.2
Italie,ITA,2019,15,11282,NA,11241,41,0.4
Italie,ITA,2019,16,11360,NA,11040,320,2.9
Italie,ITA,2019,17,11086,NA,10974,112,1
Italie,ITA,2019,18,10766,NA,10827,-61,-0.6
Italie,ITA,2019,19,10981,NA,10756,225,2.1
Italie,ITA,2019,20,10847,NA,10557,290,2.7
Italie,ITA,2019,21,10906,NA,10790,116,1.1
Italie,ITA,2019,22,10624,NA,10534,90,0.9
Italie,ITA,2019,23,11487,NA,10576,911,8.6
Italie,ITA,2019,24,11192,NA,10602,590,5.6
Italie,ITA,2019,25,10658,NA,10674,-16,-0.1
Italie,ITA,2019,26,11903,NA,10692,1211,11.3
Italie,ITA,2019,27,11590,NA,10763,827,7.7
Italie,ITA,2019,28,10878,NA,10693,185,1.7
Italie,ITA,2019,29,10304,NA,10416,-112,-1.1
Italie,ITA,2019,30,11282,NA,10601,681,6.4
Italie,ITA,2019,31,10291,NA,11059,-768,-6.9
Italie,ITA,2019,32,10647,NA,11336,-689,-6.1
Italie,ITA,2019,33,10523,NA,10588,-65,-0.6
Italie,ITA,2019,34,10342,NA,10416,-74,-0.7
Italie,ITA,2019,35,10239,NA,10229,10,0.1
Italie,ITA,2019,36,9814,NA,9967,-153,-1.5
Italie,ITA,2019,37,10323,NA,10166,157,1.5
Italie,ITA,2019,38,10241,NA,10170,71,0.7
Italie,ITA,2019,39,10274,NA,10401,-127,-1.2
Italie,ITA,2019,40,10281,NA,10582,-301,-2.8
Italie,ITA,2019,41,10739,NA,11119,-380,-3.4
Italie,ITA,2019,42,10761,NA,11010,-249,-2.3
Italie,ITA,2019,43,11059,NA,11110,-51,-0.5
Italie,ITA,2019,44,10546,NA,10839,-293,-2.7
Italie,ITA,2019,45,11001,NA,11172,-171,-1.5
Italie,ITA,2019,46,11357,NA,11445,-88,-0.8
Italie,ITA,2019,47,11264,NA,11507,-243,-2.1
Italie,ITA,2019,48,11287,NA,11527,-240,-2.1
Italie,ITA,2019,49,11156,NA,11742,-586,-5
Italie,ITA,2019,50,11934,NA,12258,-324,-2.6
Italie,ITA,2019,51,12216,NA,12825,-609,-4.7
Italie,ITA,2019,52,11653,NA,13437,-1784,-13.3
Italie,ITA,2020,1,12515,0,14455,-1940,-13.4
Italie,ITA,2020,2,13013,0,14665,-1652,-11.3
Italie,ITA,2020,3,13074,0,14464,-1390,-9.6
Italie,ITA,2020,4,13037,0,13982,-945,-6.8
Italie,ITA,2020,5,12884,0,13778,-894,-6.5
Italie,ITA,2020,6,12603,0,13132,-529,-4
Italie,ITA,2020,7,12633,0,12950,-317,-2.4
Italie,ITA,2020,8,12267,6,12744,-477,-3.7
Italie,ITA,2020,9,12700,46,12792,-92,-0.7
Italie,ITA,2020,10,13674,412,12534,1140,9.1
Italie,ITA,2020,11,17130,1694,12185,4945,40.6
Italie,ITA,2020,12,20683,3919,11695,8988,76.9
Italie,ITA,2020,13,22000,5514,11714,10286,87.8
Italie,ITA,2020,14,19179,4934,11510,7669,66.6
Italie,ITA,2020,15,17260,3940,11241,6019,53.5
Italie,ITA,2020,16,15122,3649,11040,4082,37
Italie,ITA,2020,17,13204,2863,10974,2230,20.3
Italie,ITA,2020,18,11738,2102,10827,911,8.4
Italie,ITA,2020,19,11014,1660,10756,258,2.4
Lituanie,LTU,2016,1,845,NA,868,-23,-2.6
Lituanie,LTU,2016,2,896,NA,885,11,1.2
Lituanie,LTU,2016,3,936,NA,924,12,1.3
Lituanie,LTU,2016,4,906,NA,926,-20,-2.2
Lituanie,LTU,2016,5,913,NA,919,-6,-0.7
Lituanie,LTU,2016,6,891,NA,906,-15,-1.7
Lituanie,LTU,2016,7,836,NA,865,-29,-3.4
Lituanie,LTU,2016,8,862,NA,891,-29,-3.3
Lituanie,LTU,2016,9,826,NA,850,-24,-2.8
Lituanie,LTU,2016,10,820,NA,824,-4,-0.5
Lituanie,LTU,2016,11,826,NA,800,26,3.2
Lituanie,LTU,2016,12,766,NA,778,-12,-1.5
Lituanie,LTU,2016,13,824,NA,768,56,7.3
Lituanie,LTU,2016,14,790,NA,782,8,1
Lituanie,LTU,2016,15,804,NA,770,34,4.4
Lituanie,LTU,2016,16,793,NA,759,34,4.5
Lituanie,LTU,2016,17,773,NA,756,17,2.2
Lituanie,LTU,2016,18,767,NA,740,27,3.6
Lituanie,LTU,2016,19,757,NA,754,3,0.4
Lituanie,LTU,2016,20,723,NA,730,-7,-1
Lituanie,LTU,2016,21,813,NA,770,43,5.6
Lituanie,LTU,2016,22,843,NA,743,100,13.5
Lituanie,LTU,2016,23,727,NA,715,12,1.7
Lituanie,LTU,2016,24,664,NA,704,-40,-5.7
Lituanie,LTU,2016,25,760,NA,701,59,8.4
Lituanie,LTU,2016,26,860,NA,738,122,16.5
Lituanie,LTU,2016,27,688,NA,664,24,3.6
Lituanie,LTU,2016,28,675,NA,687,-12,-1.7
Lituanie,LTU,2016,29,723,NA,708,15,2.1
Lituanie,LTU,2016,30,785,NA,743,42,5.7
Lituanie,LTU,2016,31,690,NA,689,1,0.1
Lituanie,LTU,2016,32,665,NA,693,-28,-4
Lituanie,LTU,2016,33,715,NA,684,31,4.5
Lituanie,LTU,2016,34,760,NA,682,78,11.4
Lituanie,LTU,2016,35,735,NA,700,35,5
Lituanie,LTU,2016,36,709,NA,672,37,5.5
Lituanie,LTU,2016,37,653,NA,653,0,0
Lituanie,LTU,2016,38,732,NA,686,46,6.7
Lituanie,LTU,2016,39,743,NA,714,29,4.1
Lituanie,LTU,2016,40,760,NA,736,24,3.3
Lituanie,LTU,2016,41,795,NA,736,59,8
Lituanie,LTU,2016,42,814,NA,758,56,7.4
Lituanie,LTU,2016,43,810,NA,750,60,8
Lituanie,LTU,2016,44,794,NA,740,54,7.3
Lituanie,LTU,2016,45,822,NA,740,82,11.1
Lituanie,LTU,2016,46,802,NA,731,71,9.7
Lituanie,LTU,2016,47,776,NA,744,32,4.3
Lituanie,LTU,2016,48,752,NA,747,5,0.7
Lituanie,LTU,2016,49,752,NA,766,-14,-1.8
Lituanie,LTU,2016,50,759,NA,738,21,2.8
Lituanie,LTU,2016,51,856,NA,782,74,9.5
Lituanie,LTU,2016,52,873,NA,810,63,7.8
Lituanie,LTU,2017,1,958,NA,868,90,10.4
Lituanie,LTU,2017,2,979,NA,885,94,10.6
Lituanie,LTU,2017,3,970,NA,924,46,5
Lituanie,LTU,2017,4,953,NA,926,27,2.9
Lituanie,LTU,2017,5,958,NA,919,39,4.2
Lituanie,LTU,2017,6,923,NA,906,17,1.9
Lituanie,LTU,2017,7,877,NA,865,12,1.4
Lituanie,LTU,2017,8,905,NA,891,14,1.6
Lituanie,LTU,2017,9,828,NA,850,-22,-2.6
Lituanie,LTU,2017,10,790,NA,824,-34,-4.1
Lituanie,LTU,2017,11,763,NA,800,-37,-4.6
Lituanie,LTU,2017,12,765,NA,778,-13,-1.7
Lituanie,LTU,2017,13,771,NA,768,3,0.4
Lituanie,LTU,2017,14,757,NA,782,-25,-3.2
Lituanie,LTU,2017,15,761,NA,770,-9,-1.2
Lituanie,LTU,2017,16,749,NA,759,-10,-1.3
Lituanie,LTU,2017,17,778,NA,756,22,2.9
Lituanie,LTU,2017,18,742,NA,740,2,0.3
Lituanie,LTU,2017,19,793,NA,754,39,5.2
Lituanie,LTU,2017,20,762,NA,730,32,4.4
Lituanie,LTU,2017,21,771,NA,770,1,0.1
Lituanie,LTU,2017,22,691,NA,743,-52,-7
Lituanie,LTU,2017,23,723,NA,715,8,1.1
Lituanie,LTU,2017,24,703,NA,704,-1,-0.1
Lituanie,LTU,2017,25,723,NA,701,22,3.1
Lituanie,LTU,2017,26,700,NA,738,-38,-5.1
Lituanie,LTU,2017,27,668,NA,664,4,0.6
Lituanie,LTU,2017,28,711,NA,687,24,3.5
Lituanie,LTU,2017,29,697,NA,708,-11,-1.6
Lituanie,LTU,2017,30,741,NA,743,-2,-0.3
Lituanie,LTU,2017,31,647,NA,689,-42,-6.1
Lituanie,LTU,2017,32,707,NA,693,14,2
Lituanie,LTU,2017,33,680,NA,684,-4,-0.6
Lituanie,LTU,2017,34,595,NA,682,-87,-12.8
Lituanie,LTU,2017,35,728,NA,700,28,4
Lituanie,LTU,2017,36,688,NA,672,16,2.4
Lituanie,LTU,2017,37,679,NA,653,26,4
Lituanie,LTU,2017,38,714,NA,686,28,4.1
Lituanie,LTU,2017,39,723,NA,714,9,1.3
Lituanie,LTU,2017,40,768,NA,736,32,4.3
Lituanie,LTU,2017,41,742,NA,736,6,0.8
Lituanie,LTU,2017,42,773,NA,758,15,2
Lituanie,LTU,2017,43,777,NA,750,27,3.6
Lituanie,LTU,2017,44,788,NA,740,48,6.5
Lituanie,LTU,2017,45,732,NA,740,-8,-1.1
Lituanie,LTU,2017,46,784,NA,731,53,7.3
Lituanie,LTU,2017,47,770,NA,744,26,3.5
Lituanie,LTU,2017,48,721,NA,747,-26,-3.5
Lituanie,LTU,2017,49,790,NA,766,24,3.1
Lituanie,LTU,2017,50,693,NA,738,-45,-6.1
Lituanie,LTU,2017,51,781,NA,782,-1,-0.1
Lituanie,LTU,2017,52,800,NA,810,-10,-1.2
Lituanie,LTU,2018,1,826,NA,868,-42,-4.8
Lituanie,LTU,2018,2,788,NA,885,-97,-11
Lituanie,LTU,2018,3,879,NA,924,-45,-4.9
Lituanie,LTU,2018,4,862,NA,926,-64,-6.9
Lituanie,LTU,2018,5,911,NA,919,-8,-0.9
Lituanie,LTU,2018,6,957,NA,906,51,5.6
Lituanie,LTU,2018,7,947,NA,865,82,9.5
Lituanie,LTU,2018,8,965,NA,891,74,8.3
Lituanie,LTU,2018,9,964,NA,850,114,13.4
Lituanie,LTU,2018,10,903,NA,824,79,9.6
Lituanie,LTU,2018,11,858,NA,800,58,7.2
Lituanie,LTU,2018,12,802,NA,778,24,3.1
Lituanie,LTU,2018,13,800,NA,768,32,4.2
Lituanie,LTU,2018,14,856,NA,782,74,9.5
Lituanie,LTU,2018,15,790,NA,770,20,2.6
Lituanie,LTU,2018,16,785,NA,759,26,3.4
Lituanie,LTU,2018,17,701,NA,756,-55,-7.3
Lituanie,LTU,2018,18,739,NA,740,-1,-0.1
Lituanie,LTU,2018,19,777,NA,754,23,3.1
Lituanie,LTU,2018,20,726,NA,730,-4,-0.5
Lituanie,LTU,2018,21,708,NA,770,-62,-8.1
Lituanie,LTU,2018,22,730,NA,743,-13,-1.7
Lituanie,LTU,2018,23,622,NA,715,-93,-13
Lituanie,LTU,2018,24,688,NA,704,-16,-2.3
Lituanie,LTU,2018,25,662,NA,701,-39,-5.6
Lituanie,LTU,2018,26,648,NA,738,-90,-12.2
Lituanie,LTU,2018,27,623,NA,664,-41,-6.2
Lituanie,LTU,2018,28,691,NA,687,4,0.6
Lituanie,LTU,2018,29,733,NA,708,25,3.5
Lituanie,LTU,2018,30,719,NA,743,-24,-3.2
Lituanie,LTU,2018,31,807,NA,689,118,17.1
Lituanie,LTU,2018,32,736,NA,693,43,6.2
Lituanie,LTU,2018,33,678,NA,684,-6,-0.9
Lituanie,LTU,2018,34,694,NA,682,12,1.8
Lituanie,LTU,2018,35,623,NA,700,-77,-11
Lituanie,LTU,2018,36,627,NA,672,-45,-6.7
Lituanie,LTU,2018,37,645,NA,653,-8,-1.2
Lituanie,LTU,2018,38,658,NA,686,-28,-4.1
Lituanie,LTU,2018,39,682,NA,714,-32,-4.5
Lituanie,LTU,2018,40,701,NA,736,-35,-4.8
Lituanie,LTU,2018,41,729,NA,736,-7,-1
Lituanie,LTU,2018,42,711,NA,758,-47,-6.2
Lituanie,LTU,2018,43,753,NA,750,3,0.4
Lituanie,LTU,2018,44,706,NA,740,-34,-4.6
Lituanie,LTU,2018,45,686,NA,740,-54,-7.3
Lituanie,LTU,2018,46,681,NA,731,-50,-6.8
Lituanie,LTU,2018,47,727,NA,744,-17,-2.3
Lituanie,LTU,2018,48,741,NA,747,-6,-0.8
Lituanie,LTU,2018,49,843,NA,766,77,10.1
Lituanie,LTU,2018,50,773,NA,738,35,4.7
Lituanie,LTU,2018,51,770,NA,782,-12,-1.5
Lituanie,LTU,2018,52,821,NA,810,11,1.4
Lituanie,LTU,2019,1,842,NA,868,-26,-3
Lituanie,LTU,2019,2,878,NA,885,-7,-0.8
Lituanie,LTU,2019,3,910,NA,924,-14,-1.5
Lituanie,LTU,2019,4,982,NA,926,56,6
Lituanie,LTU,2019,5,895,NA,919,-24,-2.6
Lituanie,LTU,2019,6,854,NA,906,-52,-5.7
Lituanie,LTU,2019,7,800,NA,865,-65,-7.5
Lituanie,LTU,2019,8,831,NA,891,-60,-6.7
Lituanie,LTU,2019,9,783,NA,850,-67,-7.9
Lituanie,LTU,2019,10,783,NA,824,-41,-5
Lituanie,LTU,2019,11,754,NA,800,-46,-5.8
Lituanie,LTU,2019,12,780,NA,778,2,0.3
Lituanie,LTU,2019,13,678,NA,768,-90,-11.7
Lituanie,LTU,2019,14,726,NA,782,-56,-7.2
Lituanie,LTU,2019,15,723,NA,770,-47,-6.1
Lituanie,LTU,2019,16,709,NA,759,-50,-6.6
Lituanie,LTU,2019,17,773,NA,756,17,2.2
Lituanie,LTU,2019,18,714,NA,740,-26,-3.5
Lituanie,LTU,2019,19,691,NA,754,-63,-8.4
Lituanie,LTU,2019,20,707,NA,730,-23,-3.2
Lituanie,LTU,2019,21,788,NA,770,18,2.3
Lituanie,LTU,2019,22,708,NA,743,-35,-4.7
Lituanie,LTU,2019,23,788,NA,715,73,10.2
Lituanie,LTU,2019,24,763,NA,704,59,8.4
Lituanie,LTU,2019,25,660,NA,701,-41,-5.8
Lituanie,LTU,2019,26,746,NA,738,8,1.1
Lituanie,LTU,2019,27,677,NA,664,13,2
Lituanie,LTU,2019,28,671,NA,687,-16,-2.3
Lituanie,LTU,2019,29,681,NA,708,-27,-3.8
Lituanie,LTU,2019,30,727,NA,743,-16,-2.2
Lituanie,LTU,2019,31,611,NA,689,-78,-11.3
Lituanie,LTU,2019,32,665,NA,693,-28,-4
Lituanie,LTU,2019,33,661,NA,684,-23,-3.4
Lituanie,LTU,2019,34,680,NA,682,-2,-0.3
Lituanie,LTU,2019,35,715,NA,700,15,2.1
Lituanie,LTU,2019,36,662,NA,672,-10,-1.5
Lituanie,LTU,2019,37,635,NA,653,-18,-2.8
Lituanie,LTU,2019,38,641,NA,686,-45,-6.6
Lituanie,LTU,2019,39,708,NA,714,-6,-0.8
Lituanie,LTU,2019,40,714,NA,736,-22,-3
Lituanie,LTU,2019,41,678,NA,736,-58,-7.9
Lituanie,LTU,2019,42,732,NA,758,-26,-3.4
Lituanie,LTU,2019,43,661,NA,750,-89,-11.9
Lituanie,LTU,2019,44,671,NA,740,-69,-9.3
Lituanie,LTU,2019,45,720,NA,740,-20,-2.7
Lituanie,LTU,2019,46,657,NA,731,-74,-10.1
Lituanie,LTU,2019,47,702,NA,744,-42,-5.6
Lituanie,LTU,2019,48,774,NA,747,27,3.6
Lituanie,LTU,2019,49,681,NA,766,-85,-11.1
Lituanie,LTU,2019,50,726,NA,738,-12,-1.6
Lituanie,LTU,2019,51,720,NA,782,-62,-7.9
Lituanie,LTU,2019,52,748,NA,810,-62,-7.7
Lituanie,LTU,2020,1,538,0,868,-330,-38
Lituanie,LTU,2020,2,807,0,885,-78,-8.8
Lituanie,LTU,2020,3,783,0,924,-141,-15.3
Lituanie,LTU,2020,4,763,0,926,-163,-17.6
Lituanie,LTU,2020,5,793,0,919,-126,-13.7
Lituanie,LTU,2020,6,744,0,906,-162,-17.9
Lituanie,LTU,2020,7,813,0,865,-52,-6
Lituanie,LTU,2020,8,719,0,891,-172,-19.3
Lituanie,LTU,2020,9,793,0,850,-57,-6.7
Lituanie,LTU,2020,10,827,NA,824,3,0.4
Lituanie,LTU,2020,11,696,0,800,-104,-13
Lituanie,LTU,2020,12,843,1,778,65,8.4
Lituanie,LTU,2020,13,772,6,768,4,0.5
Lituanie,LTU,2020,14,808,7,782,26,3.3
Lituanie,LTU,2020,15,773,10,770,3,0.4
Lituanie,LTU,2020,16,759,13,759,0,0
Lituanie,LTU,2020,17,791,4,756,35,4.6
Lituanie,LTU,2020,18,688,5,740,-52,-7
Lituanie,LTU,2020,19,805,4,754,51,6.8
Lituanie,LTU,2020,20,717,9,730,-13,-1.8
Lituanie,LTU,2020,21,733,4,770,-37,-4.8
Lituanie,LTU,2020,22,721,7,743,-22,-3
Lituanie,LTU,2020,23,744,1,715,29,4.1
Lituanie,LTU,2020,24,816,5,704,112,15.9
Lituanie,LTU,2020,25,764,0,701,63,9
Luxembourg,LUX,2016,1,75,NA,88,-13,-14.8
Luxembourg,LUX,2016,2,81,NA,96,-15,-15.6
Luxembourg,LUX,2016,3,85,NA,89,-4,-4.5
Luxembourg,LUX,2016,4,83,NA,88,-5,-5.7
Luxembourg,LUX,2016,5,79,NA,96,-17,-17.7
Luxembourg,LUX,2016,6,72,NA,96,-24,-25
Luxembourg,LUX,2016,7,85,NA,98,-13,-13.3
Luxembourg,LUX,2016,8,65,NA,84,-19,-22.6
Luxembourg,LUX,2016,9,82,NA,88,-6,-6.8
Luxembourg,LUX,2016,10,91,NA,100,-9,-9
Luxembourg,LUX,2016,11,86,NA,81,5,6.2
Luxembourg,LUX,2016,12,91,NA,89,2,2.2
Luxembourg,LUX,2016,13,82,NA,86,-4,-4.7
Luxembourg,LUX,2016,14,78,NA,82,-4,-4.9
Luxembourg,LUX,2016,15,70,NA,71,-1,-1.4
Luxembourg,LUX,2016,16,71,NA,79,-8,-10.1
Luxembourg,LUX,2016,17,63,NA,75,-12,-16
Luxembourg,LUX,2016,18,76,NA,74,2,2.7
Luxembourg,LUX,2016,19,68,NA,71,-3,-4.2
Luxembourg,LUX,2016,20,77,NA,73,4,5.5
Luxembourg,LUX,2016,21,82,NA,80,2,2.5
Luxembourg,LUX,2016,22,72,NA,67,5,7.5
Luxembourg,LUX,2016,23,62,NA,74,-12,-16.2
Luxembourg,LUX,2016,24,81,NA,77,4,5.2
Luxembourg,LUX,2016,25,71,NA,64,7,10.9
Luxembourg,LUX,2016,26,49,NA,72,-23,-31.9
Luxembourg,LUX,2016,27,70,NA,72,-2,-2.8
Luxembourg,LUX,2016,28,80,NA,78,2,2.6
Luxembourg,LUX,2016,29,77,NA,73,4,5.5
Luxembourg,LUX,2016,30,74,NA,79,-5,-6.3
Luxembourg,LUX,2016,31,64,NA,76,-12,-15.8
Luxembourg,LUX,2016,32,69,NA,76,-7,-9.2
Luxembourg,LUX,2016,33,72,NA,75,-3,-4
Luxembourg,LUX,2016,34,69,NA,66,3,4.5
Luxembourg,LUX,2016,35,85,NA,78,7,9
Luxembourg,LUX,2016,36,71,NA,77,-6,-7.8
Luxembourg,LUX,2016,37,73,NA,72,1,1.4
Luxembourg,LUX,2016,38,61,NA,68,-7,-10.3
Luxembourg,LUX,2016,39,77,NA,84,-7,-8.3
Luxembourg,LUX,2016,40,69,NA,80,-11,-13.8
Luxembourg,LUX,2016,41,85,NA,89,-4,-4.5
Luxembourg,LUX,2016,42,80,NA,77,3,3.9
Luxembourg,LUX,2016,43,71,NA,75,-4,-5.3
Luxembourg,LUX,2016,44,72,NA,86,-14,-16.3
Luxembourg,LUX,2016,45,76,NA,85,-9,-10.6
Luxembourg,LUX,2016,46,82,NA,82,0,0
Luxembourg,LUX,2016,47,73,NA,87,-14,-16.1
Luxembourg,LUX,2016,48,79,NA,78,1,1.3
Luxembourg,LUX,2016,49,81,NA,84,-3,-3.6
Luxembourg,LUX,2016,50,86,NA,84,2,2.4
Luxembourg,LUX,2016,51,76,NA,84,-8,-9.5
Luxembourg,LUX,2016,52,93,NA,91,2,2.2
Luxembourg,LUX,2017,1,95,NA,88,7,8
Luxembourg,LUX,2017,2,123,NA,96,27,28.1
Luxembourg,LUX,2017,3,107,NA,89,18,20.2
Luxembourg,LUX,2017,4,101,NA,88,13,14.8
Luxembourg,LUX,2017,5,110,NA,96,14,14.6
Luxembourg,LUX,2017,6,92,NA,96,-4,-4.2
Luxembourg,LUX,2017,7,86,NA,98,-12,-12.2
Luxembourg,LUX,2017,8,71,NA,84,-13,-15.5
Luxembourg,LUX,2017,9,67,NA,88,-21,-23.9
Luxembourg,LUX,2017,10,89,NA,100,-11,-11
Luxembourg,LUX,2017,11,75,NA,81,-6,-7.4
Luxembourg,LUX,2017,12,89,NA,89,0,0
Luxembourg,LUX,2017,13,99,NA,86,13,15.1
Luxembourg,LUX,2017,14,97,NA,82,15,18.3
Luxembourg,LUX,2017,15,63,NA,71,-8,-11.3
Luxembourg,LUX,2017,16,83,NA,79,4,5.1
Luxembourg,LUX,2017,17,90,NA,75,15,20
Luxembourg,LUX,2017,18,74,NA,74,0,0
Luxembourg,LUX,2017,19,73,NA,71,2,2.8
Luxembourg,LUX,2017,20,63,NA,73,-10,-13.7
Luxembourg,LUX,2017,21,72,NA,80,-8,-10
Luxembourg,LUX,2017,22,64,NA,67,-3,-4.5
Luxembourg,LUX,2017,23,76,NA,74,2,2.7
Luxembourg,LUX,2017,24,86,NA,77,9,11.7
Luxembourg,LUX,2017,25,66,NA,64,2,3.1
Luxembourg,LUX,2017,26,72,NA,72,0,0
Luxembourg,LUX,2017,27,71,NA,72,-1,-1.4
Luxembourg,LUX,2017,28,85,NA,78,7,9
Luxembourg,LUX,2017,29,76,NA,73,3,4.1
Luxembourg,LUX,2017,30,83,NA,79,4,5.1
Luxembourg,LUX,2017,31,66,NA,76,-10,-13.2
Luxembourg,LUX,2017,32,59,NA,76,-17,-22.4
Luxembourg,LUX,2017,33,67,NA,75,-8,-10.7
Luxembourg,LUX,2017,34,71,NA,66,5,7.6
Luxembourg,LUX,2017,35,76,NA,78,-2,-2.6
Luxembourg,LUX,2017,36,75,NA,77,-2,-2.6
Luxembourg,LUX,2017,37,78,NA,72,6,8.3
Luxembourg,LUX,2017,38,79,NA,68,11,16.2
Luxembourg,LUX,2017,39,88,NA,84,4,4.8
Luxembourg,LUX,2017,40,78,NA,80,-2,-2.5
Luxembourg,LUX,2017,41,94,NA,89,5,5.6
Luxembourg,LUX,2017,42,80,NA,77,3,3.9
Luxembourg,LUX,2017,43,84,NA,75,9,12
Luxembourg,LUX,2017,44,84,NA,86,-2,-2.3
Luxembourg,LUX,2017,45,77,NA,85,-8,-9.4
Luxembourg,LUX,2017,46,75,NA,82,-7,-8.5
Luxembourg,LUX,2017,47,96,NA,87,9,10.3
Luxembourg,LUX,2017,48,70,NA,78,-8,-10.3
Luxembourg,LUX,2017,49,97,NA,84,13,15.5
Luxembourg,LUX,2017,50,78,NA,84,-6,-7.1
Luxembourg,LUX,2017,51,85,NA,84,1,1.2
Luxembourg,LUX,2017,52,96,NA,91,5,5.5
Luxembourg,LUX,2018,1,85,NA,88,-3,-3.4
Luxembourg,LUX,2018,2,100,NA,96,4,4.2
Luxembourg,LUX,2018,3,84,NA,89,-5,-5.6
Luxembourg,LUX,2018,4,85,NA,88,-3,-3.4
Luxembourg,LUX,2018,5,96,NA,96,0,0
Luxembourg,LUX,2018,6,115,NA,96,19,19.8
Luxembourg,LUX,2018,7,111,NA,98,13,13.3
Luxembourg,LUX,2018,8,112,NA,84,28,33.3
Luxembourg,LUX,2018,9,111,NA,88,23,26.1
Luxembourg,LUX,2018,10,135,NA,100,35,35
Luxembourg,LUX,2018,11,85,NA,81,4,4.9
Luxembourg,LUX,2018,12,94,NA,89,5,5.6
Luxembourg,LUX,2018,13,70,NA,86,-16,-18.6
Luxembourg,LUX,2018,14,75,NA,82,-7,-8.5
Luxembourg,LUX,2018,15,80,NA,71,9,12.7
Luxembourg,LUX,2018,16,83,NA,79,4,5.1
Luxembourg,LUX,2018,17,64,NA,75,-11,-14.7
Luxembourg,LUX,2018,18,67,NA,74,-7,-9.5
Luxembourg,LUX,2018,19,77,NA,71,6,8.5
Luxembourg,LUX,2018,20,75,NA,73,2,2.7
Luxembourg,LUX,2018,21,84,NA,80,4,5
Luxembourg,LUX,2018,22,53,NA,67,-14,-20.9
Luxembourg,LUX,2018,23,89,NA,74,15,20.3
Luxembourg,LUX,2018,24,74,NA,77,-3,-3.9
Luxembourg,LUX,2018,25,57,NA,64,-7,-10.9
Luxembourg,LUX,2018,26,77,NA,72,5,6.9
Luxembourg,LUX,2018,27,77,NA,72,5,6.9
Luxembourg,LUX,2018,28,63,NA,78,-15,-19.2
Luxembourg,LUX,2018,29,69,NA,73,-4,-5.5
Luxembourg,LUX,2018,30,88,NA,79,9,11.4
Luxembourg,LUX,2018,31,100,NA,76,24,31.6
Luxembourg,LUX,2018,32,95,NA,76,19,25
Luxembourg,LUX,2018,33,81,NA,75,6,8
Luxembourg,LUX,2018,34,58,NA,66,-8,-12.1
Luxembourg,LUX,2018,35,72,NA,78,-6,-7.7
Luxembourg,LUX,2018,36,88,NA,77,11,14.3
Luxembourg,LUX,2018,37,60,NA,72,-12,-16.7
Luxembourg,LUX,2018,38,60,NA,68,-8,-11.8
Luxembourg,LUX,2018,39,84,NA,84,0,0
Luxembourg,LUX,2018,40,91,NA,80,11,13.8
Luxembourg,LUX,2018,41,90,NA,89,1,1.1
Luxembourg,LUX,2018,42,86,NA,77,9,11.7
Luxembourg,LUX,2018,43,61,NA,75,-14,-18.7
Luxembourg,LUX,2018,44,83,NA,86,-3,-3.5
Luxembourg,LUX,2018,45,98,NA,85,13,15.3
Luxembourg,LUX,2018,46,70,NA,82,-12,-14.6
Luxembourg,LUX,2018,47,89,NA,87,2,2.3
Luxembourg,LUX,2018,48,72,NA,78,-6,-7.7
Luxembourg,LUX,2018,49,69,NA,84,-15,-17.9
Luxembourg,LUX,2018,50,85,NA,84,1,1.2
Luxembourg,LUX,2018,51,92,NA,84,8,9.5
Luxembourg,LUX,2018,52,81,NA,91,-10,-11
Luxembourg,LUX,2019,1,98,NA,88,10,11.4
Luxembourg,LUX,2019,2,82,NA,96,-14,-14.6
Luxembourg,LUX,2019,3,81,NA,89,-8,-9
Luxembourg,LUX,2019,4,83,NA,88,-5,-5.7
Luxembourg,LUX,2019,5,101,NA,96,5,5.2
Luxembourg,LUX,2019,6,106,NA,96,10,10.4
Luxembourg,LUX,2019,7,112,NA,98,14,14.3
Luxembourg,LUX,2019,8,89,NA,84,5,6
Luxembourg,LUX,2019,9,90,NA,88,2,2.3
Luxembourg,LUX,2019,10,83,NA,100,-17,-17
Luxembourg,LUX,2019,11,78,NA,81,-3,-3.7
Luxembourg,LUX,2019,12,83,NA,89,-6,-6.7
Luxembourg,LUX,2019,13,92,NA,86,6,7
Luxembourg,LUX,2019,14,77,NA,82,-5,-6.1
Luxembourg,LUX,2019,15,70,NA,71,-1,-1.4
Luxembourg,LUX,2019,16,78,NA,79,-1,-1.3
Luxembourg,LUX,2019,17,82,NA,75,7,9.3
Luxembourg,LUX,2019,18,81,NA,74,7,9.5
Luxembourg,LUX,2019,19,66,NA,71,-5,-7
Luxembourg,LUX,2019,20,77,NA,73,4,5.5
Luxembourg,LUX,2019,21,82,NA,80,2,2.5
Luxembourg,LUX,2019,22,80,NA,67,13,19.4
Luxembourg,LUX,2019,23,71,NA,74,-3,-4.1
Luxembourg,LUX,2019,24,67,NA,77,-10,-13
Luxembourg,LUX,2019,25,63,NA,64,-1,-1.6
Luxembourg,LUX,2019,26,92,NA,72,20,27.8
Luxembourg,LUX,2019,27,71,NA,72,-1,-1.4
Luxembourg,LUX,2019,28,86,NA,78,8,10.3
Luxembourg,LUX,2019,29,70,NA,73,-3,-4.1
Luxembourg,LUX,2019,30,72,NA,79,-7,-8.9
Luxembourg,LUX,2019,31,72,NA,76,-4,-5.3
Luxembourg,LUX,2019,32,82,NA,76,6,7.9
Luxembourg,LUX,2019,33,79,NA,75,4,5.3
Luxembourg,LUX,2019,34,65,NA,66,-1,-1.5
Luxembourg,LUX,2019,35,77,NA,78,-1,-1.3
Luxembourg,LUX,2019,36,73,NA,77,-4,-5.2
Luxembourg,LUX,2019,37,78,NA,72,6,8.3
Luxembourg,LUX,2019,38,72,NA,68,4,5.9
Luxembourg,LUX,2019,39,85,NA,84,1,1.2
Luxembourg,LUX,2019,40,83,NA,80,3,3.8
Luxembourg,LUX,2019,41,87,NA,89,-2,-2.2
Luxembourg,LUX,2019,42,62,NA,77,-15,-19.5
Luxembourg,LUX,2019,43,83,NA,75,8,10.7
Luxembourg,LUX,2019,44,103,NA,86,17,19.8
Luxembourg,LUX,2019,45,90,NA,85,5,5.9
Luxembourg,LUX,2019,46,102,NA,82,20,24.4
Luxembourg,LUX,2019,47,89,NA,87,2,2.3
Luxembourg,LUX,2019,48,89,NA,78,11,14.1
Luxembourg,LUX,2019,49,87,NA,84,3,3.6
Luxembourg,LUX,2019,50,89,NA,84,5,6
Luxembourg,LUX,2019,51,83,NA,84,-1,-1.2
Luxembourg,LUX,2019,52,95,NA,91,4,4.4
Luxembourg,LUX,2020,1,63,0,88,-25,-28.4
Luxembourg,LUX,2020,2,87,0,96,-9,-9.4
Luxembourg,LUX,2020,3,90,0,89,1,1.1
Luxembourg,LUX,2020,4,87,0,88,-1,-1.1
Luxembourg,LUX,2020,5,88,0,96,-8,-8.3
Luxembourg,LUX,2020,6,90,0,96,-6,-6.2
Luxembourg,LUX,2020,7,69,0,98,-29,-29.6
Luxembourg,LUX,2020,8,85,0,84,1,1.2
Luxembourg,LUX,2020,9,74,0,88,-14,-15.9
Luxembourg,LUX,2020,10,91,0,100,-9,-9
Luxembourg,LUX,2020,11,91,1,81,10,12.3
Luxembourg,LUX,2020,12,89,7,89,0,0
Luxembourg,LUX,2020,13,112,14,86,26,30.2
Luxembourg,LUX,2020,14,90,19,82,8,9.8
Luxembourg,LUX,2020,15,116,26,71,45,63.4
Luxembourg,LUX,2020,16,89,8,79,10,12.7
Luxembourg,LUX,2020,17,84,13,75,9,12
Pays-Bas,NLD,2016,1,2920,NA,3223,-303,-9.4
Pays-Bas,NLD,2016,2,3173,NA,3358,-185,-5.5
Pays-Bas,NLD,2016,3,3075,NA,3269,-194,-5.9
Pays-Bas,NLD,2016,4,3062,NA,3297,-235,-7.1
Pays-Bas,NLD,2016,5,3201,NA,3330,-129,-3.9
Pays-Bas,NLD,2016,6,3103,NA,3312,-209,-6.3
Pays-Bas,NLD,2016,7,3036,NA,3341,-305,-9.1
Pays-Bas,NLD,2016,8,3027,NA,3317,-290,-8.7
Pays-Bas,NLD,2016,9,3319,NA,3368,-49,-1.5
Pays-Bas,NLD,2016,10,3185,NA,3376,-191,-5.7
Pays-Bas,NLD,2016,11,3151,NA,3238,-87,-2.7
Pays-Bas,NLD,2016,12,3062,NA,3078,-16,-0.5
Pays-Bas,NLD,2016,13,3028,NA,3029,-1,-0
Pays-Bas,NLD,2016,14,3037,NA,2935,102,3.5
Pays-Bas,NLD,2016,15,3010,NA,2895,115,4
Pays-Bas,NLD,2016,16,2767,NA,2820,-53,-1.9
Pays-Bas,NLD,2016,17,2751,NA,2787,-36,-1.3
Pays-Bas,NLD,2016,18,2742,NA,2740,2,0.1
Pays-Bas,NLD,2016,19,2754,NA,2742,12,0.4
Pays-Bas,NLD,2016,20,2952,NA,2795,157,5.6
Pays-Bas,NLD,2016,21,2671,NA,2748,-77,-2.8
Pays-Bas,NLD,2016,22,2713,NA,2730,-17,-0.6
Pays-Bas,NLD,2016,23,2682,NA,2680,2,0.1
Pays-Bas,NLD,2016,24,2587,NA,2609,-22,-0.8
Pays-Bas,NLD,2016,25,2620,NA,2636,-16,-0.6
Pays-Bas,NLD,2016,26,2597,NA,2686,-89,-3.3
Pays-Bas,NLD,2016,27,2609,NA,2689,-80,-3
Pays-Bas,NLD,2016,28,2693,NA,2661,32,1.2
Pays-Bas,NLD,2016,29,2627,NA,2647,-20,-0.8
Pays-Bas,NLD,2016,30,2753,NA,2774,-21,-0.8
Pays-Bas,NLD,2016,31,2542,NA,2636,-94,-3.6
Pays-Bas,NLD,2016,32,2500,NA,2632,-132,-5
Pays-Bas,NLD,2016,33,2558,NA,2579,-21,-0.8
Pays-Bas,NLD,2016,34,2568,NA,2585,-17,-0.7
Pays-Bas,NLD,2016,35,2701,NA,2646,55,2.1
Pays-Bas,NLD,2016,36,2591,NA,2582,9,0.3
Pays-Bas,NLD,2016,37,2584,NA,2618,-34,-1.3
Pays-Bas,NLD,2016,38,2725,NA,2682,43,1.6
Pays-Bas,NLD,2016,39,2500,NA,2654,-154,-5.8
Pays-Bas,NLD,2016,40,2665,NA,2706,-41,-1.5
Pays-Bas,NLD,2016,41,2683,NA,2779,-96,-3.5
Pays-Bas,NLD,2016,42,2934,NA,2814,120,4.3
Pays-Bas,NLD,2016,43,2744,NA,2740,4,0.1
Pays-Bas,NLD,2016,44,2948,NA,2835,113,4
Pays-Bas,NLD,2016,45,2731,NA,2834,-103,-3.6
Pays-Bas,NLD,2016,46,2912,NA,2912,0,0
Pays-Bas,NLD,2016,47,2902,NA,2924,-22,-0.8
Pays-Bas,NLD,2016,48,2908,NA,2934,-26,-0.9
Pays-Bas,NLD,2016,49,2949,NA,2989,-40,-1.3
Pays-Bas,NLD,2016,50,3042,NA,3106,-64,-2.1
Pays-Bas,NLD,2016,51,3129,NA,3121,8,0.3
Pays-Bas,NLD,2016,52,3072,NA,3039,33,1.1
Pays-Bas,NLD,2017,1,3568,NA,3223,345,10.7
Pays-Bas,NLD,2017,2,3637,NA,3358,279,8.3
Pays-Bas,NLD,2017,3,3487,NA,3269,218,6.7
Pays-Bas,NLD,2017,4,3626,NA,3297,329,10
Pays-Bas,NLD,2017,5,3574,NA,3330,244,7.3
Pays-Bas,NLD,2017,6,3446,NA,3312,134,4
Pays-Bas,NLD,2017,7,3417,NA,3341,76,2.3
Pays-Bas,NLD,2017,8,3328,NA,3317,11,0.3
Pays-Bas,NLD,2017,9,3152,NA,3368,-216,-6.4
Pays-Bas,NLD,2017,10,3054,NA,3376,-322,-9.5
Pays-Bas,NLD,2017,11,2843,NA,3238,-395,-12.2
Pays-Bas,NLD,2017,12,2778,NA,3078,-300,-9.7
Pays-Bas,NLD,2017,13,2850,NA,3029,-179,-5.9
Pays-Bas,NLD,2017,14,2764,NA,2935,-171,-5.8
Pays-Bas,NLD,2017,15,2810,NA,2895,-85,-2.9
Pays-Bas,NLD,2017,16,2713,NA,2820,-107,-3.8
Pays-Bas,NLD,2017,17,2778,NA,2787,-9,-0.3
Pays-Bas,NLD,2017,18,2769,NA,2740,29,1.1
Pays-Bas,NLD,2017,19,2802,NA,2742,60,2.2
Pays-Bas,NLD,2017,20,2801,NA,2795,6,0.2
Pays-Bas,NLD,2017,21,2772,NA,2748,24,0.9
Pays-Bas,NLD,2017,22,2701,NA,2730,-29,-1.1
Pays-Bas,NLD,2017,23,2624,NA,2680,-56,-2.1
Pays-Bas,NLD,2017,24,2643,NA,2609,34,1.3
Pays-Bas,NLD,2017,25,2627,NA,2636,-9,-0.3
Pays-Bas,NLD,2017,26,2691,NA,2686,5,0.2
Pays-Bas,NLD,2017,27,2697,NA,2689,8,0.3
Pays-Bas,NLD,2017,28,2520,NA,2661,-141,-5.3
Pays-Bas,NLD,2017,29,2674,NA,2647,27,1
Pays-Bas,NLD,2017,30,2571,NA,2774,-203,-7.3
Pays-Bas,NLD,2017,31,2510,NA,2636,-126,-4.8
Pays-Bas,NLD,2017,32,2657,NA,2632,25,0.9
Pays-Bas,NLD,2017,33,2540,NA,2579,-39,-1.5
Pays-Bas,NLD,2017,34,2545,NA,2585,-40,-1.5
Pays-Bas,NLD,2017,35,2576,NA,2646,-70,-2.6
Pays-Bas,NLD,2017,36,2570,NA,2582,-12,-0.5
Pays-Bas,NLD,2017,37,2707,NA,2618,89,3.4
Pays-Bas,NLD,2017,38,2715,NA,2682,33,1.2
Pays-Bas,NLD,2017,39,2669,NA,2654,15,0.6
Pays-Bas,NLD,2017,40,2641,NA,2706,-65,-2.4
Pays-Bas,NLD,2017,41,2763,NA,2779,-16,-0.6
Pays-Bas,NLD,2017,42,2706,NA,2814,-108,-3.8
Pays-Bas,NLD,2017,43,2676,NA,2740,-64,-2.3
Pays-Bas,NLD,2017,44,2726,NA,2835,-109,-3.8
Pays-Bas,NLD,2017,45,2797,NA,2834,-37,-1.3
Pays-Bas,NLD,2017,46,2916,NA,2912,4,0.1
Pays-Bas,NLD,2017,47,2917,NA,2924,-7,-0.2
Pays-Bas,NLD,2017,48,2886,NA,2934,-48,-1.6
Pays-Bas,NLD,2017,49,3027,NA,2989,38,1.3
Pays-Bas,NLD,2017,50,3218,NA,3106,112,3.6
Pays-Bas,NLD,2017,51,3079,NA,3121,-42,-1.3
Pays-Bas,NLD,2017,52,3187,NA,3039,148,4.9
Pays-Bas,NLD,2018,1,3343,NA,3223,120,3.7
Pays-Bas,NLD,2018,2,3359,NA,3358,1,0
Pays-Bas,NLD,2018,3,3364,NA,3269,95,2.9
Pays-Bas,NLD,2018,4,3322,NA,3297,25,0.8
Pays-Bas,NLD,2018,5,3403,NA,3330,73,2.2
Pays-Bas,NLD,2018,6,3513,NA,3312,201,6.1
Pays-Bas,NLD,2018,7,3660,NA,3341,319,9.5
Pays-Bas,NLD,2018,8,3691,NA,3317,374,11.3
Pays-Bas,NLD,2018,9,3937,NA,3368,569,16.9
Pays-Bas,NLD,2018,10,4092,NA,3376,716,21.2
Pays-Bas,NLD,2018,11,3733,NA,3238,495,15.3
Pays-Bas,NLD,2018,12,3430,NA,3078,352,11.4
Pays-Bas,NLD,2018,13,3225,NA,3029,196,6.5
Pays-Bas,NLD,2018,14,3040,NA,2935,105,3.6
Pays-Bas,NLD,2018,15,2860,NA,2895,-35,-1.2
Pays-Bas,NLD,2018,16,2760,NA,2820,-60,-2.1
Pays-Bas,NLD,2018,17,2663,NA,2787,-124,-4.4
Pays-Bas,NLD,2018,18,2645,NA,2740,-95,-3.5
Pays-Bas,NLD,2018,19,2641,NA,2742,-101,-3.7
Pays-Bas,NLD,2018,20,2606,NA,2795,-189,-6.8
Pays-Bas,NLD,2018,21,2674,NA,2748,-74,-2.7
Pays-Bas,NLD,2018,22,2776,NA,2730,46,1.7
Pays-Bas,NLD,2018,23,2679,NA,2680,-1,-0
Pays-Bas,NLD,2018,24,2557,NA,2609,-52,-2
Pays-Bas,NLD,2018,25,2601,NA,2636,-35,-1.3
Pays-Bas,NLD,2018,26,2619,NA,2686,-67,-2.5
Pays-Bas,NLD,2018,27,2726,NA,2689,37,1.4
Pays-Bas,NLD,2018,28,2671,NA,2661,10,0.4
Pays-Bas,NLD,2018,29,2704,NA,2647,57,2.2
Pays-Bas,NLD,2018,30,2767,NA,2774,-7,-0.3
Pays-Bas,NLD,2018,31,2760,NA,2636,124,4.7
Pays-Bas,NLD,2018,32,2745,NA,2632,113,4.3
Pays-Bas,NLD,2018,33,2605,NA,2579,26,1
Pays-Bas,NLD,2018,34,2612,NA,2585,27,1
Pays-Bas,NLD,2018,35,2527,NA,2646,-119,-4.5
Pays-Bas,NLD,2018,36,2613,NA,2582,31,1.2
Pays-Bas,NLD,2018,37,2539,NA,2618,-79,-3
Pays-Bas,NLD,2018,38,2706,NA,2682,24,0.9
Pays-Bas,NLD,2018,39,2696,NA,2654,42,1.6
Pays-Bas,NLD,2018,40,2806,NA,2706,100,3.7
Pays-Bas,NLD,2018,41,2760,NA,2779,-19,-0.7
Pays-Bas,NLD,2018,42,2739,NA,2814,-75,-2.7
Pays-Bas,NLD,2018,43,2671,NA,2740,-69,-2.5
Pays-Bas,NLD,2018,44,2815,NA,2835,-20,-0.7
Pays-Bas,NLD,2018,45,2798,NA,2834,-36,-1.3
Pays-Bas,NLD,2018,46,2761,NA,2912,-151,-5.2
Pays-Bas,NLD,2018,47,2859,NA,2924,-65,-2.2
Pays-Bas,NLD,2018,48,2907,NA,2934,-27,-0.9
Pays-Bas,NLD,2018,49,2968,NA,2989,-21,-0.7
Pays-Bas,NLD,2018,50,3017,NA,3106,-89,-2.9
Pays-Bas,NLD,2018,51,3041,NA,3121,-80,-2.6
Pays-Bas,NLD,2018,52,2901,NA,3039,-138,-4.5
Pays-Bas,NLD,2019,1,3062,NA,3223,-161,-5
Pays-Bas,NLD,2019,2,3262,NA,3358,-96,-2.9
Pays-Bas,NLD,2019,3,3150,NA,3269,-119,-3.6
Pays-Bas,NLD,2019,4,3178,NA,3297,-119,-3.6
Pays-Bas,NLD,2019,5,3143,NA,3330,-187,-5.6
Pays-Bas,NLD,2019,6,3185,NA,3312,-127,-3.8
Pays-Bas,NLD,2019,7,3252,NA,3341,-89,-2.7
Pays-Bas,NLD,2019,8,3222,NA,3317,-95,-2.9
Pays-Bas,NLD,2019,9,3066,NA,3368,-302,-9
Pays-Bas,NLD,2019,10,3171,NA,3376,-205,-6.1
Pays-Bas,NLD,2019,11,3227,NA,3238,-11,-0.3
Pays-Bas,NLD,2019,12,3042,NA,3078,-36,-1.2
Pays-Bas,NLD,2019,13,3013,NA,3029,-16,-0.5
Pays-Bas,NLD,2019,14,2900,NA,2935,-35,-1.2
Pays-Bas,NLD,2019,15,2900,NA,2895,5,0.2
Pays-Bas,NLD,2019,16,3040,NA,2820,220,7.8
Pays-Bas,NLD,2019,17,2957,NA,2787,170,6.1
Pays-Bas,NLD,2019,18,2806,NA,2740,66,2.4
Pays-Bas,NLD,2019,19,2771,NA,2742,29,1.1
Pays-Bas,NLD,2019,20,2821,NA,2795,26,0.9
Pays-Bas,NLD,2019,21,2873,NA,2748,125,4.5
Pays-Bas,NLD,2019,22,2732,NA,2730,2,0.1
Pays-Bas,NLD,2019,23,2736,NA,2680,56,2.1
Pays-Bas,NLD,2019,24,2650,NA,2609,41,1.6
Pays-Bas,NLD,2019,25,2694,NA,2636,58,2.2
Pays-Bas,NLD,2019,26,2835,NA,2686,149,5.5
Pays-Bas,NLD,2019,27,2725,NA,2689,36,1.3
Pays-Bas,NLD,2019,28,2760,NA,2661,99,3.7
Pays-Bas,NLD,2019,29,2584,NA,2647,-63,-2.4
Pays-Bas,NLD,2019,30,3007,NA,2774,233,8.4
Pays-Bas,NLD,2019,31,2731,NA,2636,95,3.6
Pays-Bas,NLD,2019,32,2628,NA,2632,-4,-0.2
Pays-Bas,NLD,2019,33,2612,NA,2579,33,1.3
Pays-Bas,NLD,2019,34,2615,NA,2585,30,1.2
Pays-Bas,NLD,2019,35,2782,NA,2646,136,5.1
Pays-Bas,NLD,2019,36,2555,NA,2582,-27,-1
Pays-Bas,NLD,2019,37,2640,NA,2618,22,0.8
Pays-Bas,NLD,2019,38,2580,NA,2682,-102,-3.8
Pays-Bas,NLD,2019,39,2753,NA,2654,99,3.7
Pays-Bas,NLD,2019,40,2713,NA,2706,7,0.3
Pays-Bas,NLD,2019,41,2911,NA,2779,132,4.7
Pays-Bas,NLD,2019,42,2877,NA,2814,63,2.2
Pays-Bas,NLD,2019,43,2867,NA,2740,127,4.6
Pays-Bas,NLD,2019,44,2852,NA,2835,17,0.6
Pays-Bas,NLD,2019,45,3011,NA,2834,177,6.2
Pays-Bas,NLD,2019,46,3057,NA,2912,145,5
Pays-Bas,NLD,2019,47,3019,NA,2924,95,3.2
Pays-Bas,NLD,2019,48,3037,NA,2934,103,3.5
Pays-Bas,NLD,2019,49,3013,NA,2989,24,0.8
Pays-Bas,NLD,2019,50,3148,NA,3106,42,1.4
Pays-Bas,NLD,2019,51,3235,NA,3121,114,3.7
Pays-Bas,NLD,2019,52,2997,NA,3039,-42,-1.4
Pays-Bas,NLD,2020,1,3102,0,3223,-121,-3.8
Pays-Bas,NLD,2020,2,3364,0,3358,6,0.2
Pays-Bas,NLD,2020,3,3153,0,3269,-116,-3.5
Pays-Bas,NLD,2020,4,3043,0,3297,-254,-7.7
Pays-Bas,NLD,2020,5,3160,0,3330,-170,-5.1
Pays-Bas,NLD,2020,6,3192,0,3312,-120,-3.6
Pays-Bas,NLD,2020,7,3198,0,3341,-143,-4.3
Pays-Bas,NLD,2020,8,2957,0,3317,-360,-10.9
Pays-Bas,NLD,2020,9,3094,0,3368,-274,-8.1
Pays-Bas,NLD,2020,10,3098,3,3376,-278,-8.2
Pays-Bas,NLD,2020,11,3216,21,3238,-22,-0.7
Pays-Bas,NLD,2020,12,3609,189,3078,531,17.3
Pays-Bas,NLD,2020,13,4452,651,3029,1423,47
Pays-Bas,NLD,2020,14,5082,1003,2935,2147,73.2
Pays-Bas,NLD,2020,15,4973,956,2895,2078,71.8
Pays-Bas,NLD,2020,16,4294,928,2820,1474,52.3
Pays-Bas,NLD,2020,17,3899,767,2787,1112,39.9
Pays-Bas,NLD,2020,18,3373,564,2740,633,23.1
Pays-Bas,NLD,2020,19,2974,374,2742,232,8.5
Pays-Bas,NLD,2020,20,2761,238,2795,-34,-1.2
Pays-Bas,NLD,2020,21,2761,136,2748,13,0.5
Pays-Bas,NLD,2020,22,2710,132,2730,-20,-0.7
Pays-Bas,NLD,2020,23,2659,54,2680,-21,-0.8
Norvège,NOR,2016,1,870,NA,921,-51,-5.5
Norvège,NOR,2016,2,864,NA,903,-39,-4.3
Norvège,NOR,2016,3,939,NA,906,33,3.6
Norvège,NOR,2016,4,937,NA,874,63,7.2
Norvège,NOR,2016,5,881,NA,891,-10,-1.1
Norvège,NOR,2016,6,852,NA,856,-4,-0.5
Norvège,NOR,2016,7,826,NA,878,-52,-5.9
Norvège,NOR,2016,8,764,NA,852,-88,-10.3
Norvège,NOR,2016,9,873,NA,866,7,0.8
Norvège,NOR,2016,10,762,NA,842,-80,-9.5
Norvège,NOR,2016,11,798,NA,826,-28,-3.4
Norvège,NOR,2016,12,802,NA,825,-23,-2.8
Norvège,NOR,2016,13,759,NA,778,-19,-2.4
Norvège,NOR,2016,14,802,NA,803,-1,-0.1
Norvège,NOR,2016,15,773,NA,783,-10,-1.3
Norvège,NOR,2016,16,756,NA,763,-7,-0.9
Norvège,NOR,2016,17,755,NA,788,-33,-4.2
Norvège,NOR,2016,18,748,NA,756,-8,-1.1
Norvège,NOR,2016,19,711,NA,738,-27,-3.7
Norvège,NOR,2016,20,776,NA,729,47,6.4
Norvège,NOR,2016,21,713,NA,720,-7,-1
Norvège,NOR,2016,22,679,NA,713,-34,-4.8
Norvège,NOR,2016,23,669,NA,703,-34,-4.8
Norvège,NOR,2016,24,729,NA,717,12,1.7
Norvège,NOR,2016,25,725,NA,727,-2,-0.3
Norvège,NOR,2016,26,678,NA,730,-52,-7.1
Norvège,NOR,2016,27,756,NA,756,0,0
Norvège,NOR,2016,28,734,NA,724,10,1.4
Norvège,NOR,2016,29,685,NA,724,-39,-5.4
Norvège,NOR,2016,30,721,NA,736,-15,-2
Norvège,NOR,2016,31,709,NA,701,8,1.1
Norvège,NOR,2016,32,739,NA,723,16,2.2
Norvège,NOR,2016,33,717,NA,712,5,0.7
Norvège,NOR,2016,34,684,NA,714,-30,-4.2
Norvège,NOR,2016,35,723,NA,737,-14,-1.9
Norvège,NOR,2016,36,759,NA,719,40,5.6
Norvège,NOR,2016,37,714,NA,708,6,0.8
Norvège,NOR,2016,38,681,NA,713,-32,-4.5
Norvège,NOR,2016,39,740,NA,746,-6,-0.8
Norvège,NOR,2016,40,741,NA,722,19,2.6
Norvège,NOR,2016,41,731,NA,749,-18,-2.4
Norvège,NOR,2016,42,786,NA,751,35,4.7
Norvège,NOR,2016,43,773,NA,764,9,1.2
Norvège,NOR,2016,44,688,NA,756,-68,-9
Norvège,NOR,2016,45,810,NA,769,41,5.3
Norvège,NOR,2016,46,818,NA,790,28,3.5
Norvège,NOR,2016,47,855,NA,788,67,8.5
Norvège,NOR,2016,48,789,NA,785,4,0.5
Norvège,NOR,2016,49,819,NA,830,-11,-1.3
Norvège,NOR,2016,50,918,NA,825,93,11.3
Norvège,NOR,2016,51,923,NA,848,75,8.8
Norvège,NOR,2016,52,982,NA,887,95,10.7
Norvège,NOR,2017,1,1006,NA,921,85,9.2
Norvège,NOR,2017,2,1048,NA,903,145,16.1
Norvège,NOR,2017,3,928,NA,906,22,2.4
Norvège,NOR,2017,4,866,NA,874,-8,-0.9
Norvège,NOR,2017,5,914,NA,891,23,2.6
Norvège,NOR,2017,6,823,NA,856,-33,-3.9
Norvège,NOR,2017,7,845,NA,878,-33,-3.8
Norvège,NOR,2017,8,898,NA,852,46,5.4
Norvège,NOR,2017,9,863,NA,866,-3,-0.3
Norvège,NOR,2017,10,822,NA,842,-20,-2.4
Norvège,NOR,2017,11,804,NA,826,-22,-2.7
Norvège,NOR,2017,12,788,NA,825,-37,-4.5
Norvège,NOR,2017,13,756,NA,778,-22,-2.8
Norvège,NOR,2017,14,809,NA,803,6,0.7
Norvège,NOR,2017,15,776,NA,783,-7,-0.9
Norvège,NOR,2017,16,758,NA,763,-5,-0.7
Norvège,NOR,2017,17,816,NA,788,28,3.6
Norvège,NOR,2017,18,745,NA,756,-11,-1.5
Norvège,NOR,2017,19,733,NA,738,-5,-0.7
Norvège,NOR,2017,20,694,NA,729,-35,-4.8
Norvège,NOR,2017,21,735,NA,720,15,2.1
Norvège,NOR,2017,22,688,NA,713,-25,-3.5
Norvège,NOR,2017,23,724,NA,703,21,3
Norvège,NOR,2017,24,732,NA,717,15,2.1
Norvège,NOR,2017,25,757,NA,727,30,4.1
Norvège,NOR,2017,26,733,NA,730,3,0.4
Norvège,NOR,2017,27,756,NA,756,0,0
Norvège,NOR,2017,28,694,NA,724,-30,-4.1
Norvège,NOR,2017,29,748,NA,724,24,3.3
Norvège,NOR,2017,30,728,NA,736,-8,-1.1
Norvège,NOR,2017,31,691,NA,701,-10,-1.4
Norvège,NOR,2017,32,742,NA,723,19,2.6
Norvège,NOR,2017,33,704,NA,712,-8,-1.1
Norvège,NOR,2017,34,739,NA,714,25,3.5
Norvège,NOR,2017,35,730,NA,737,-7,-0.9
Norvège,NOR,2017,36,708,NA,719,-11,-1.5
Norvège,NOR,2017,37,704,NA,708,-4,-0.6
Norvège,NOR,2017,38,697,NA,713,-16,-2.2
Norvège,NOR,2017,39,713,NA,746,-33,-4.4
Norvège,NOR,2017,40,733,NA,722,11,1.5
Norvège,NOR,2017,41,764,NA,749,15,2
Norvège,NOR,2017,42,693,NA,751,-58,-7.7
Norvège,NOR,2017,43,792,NA,764,28,3.7
Norvège,NOR,2017,44,746,NA,756,-10,-1.3
Norvège,NOR,2017,45,704,NA,769,-65,-8.5
Norvège,NOR,2017,46,760,NA,790,-30,-3.8
Norvège,NOR,2017,47,791,NA,788,3,0.4
Norvège,NOR,2017,48,770,NA,785,-15,-1.9
Norvège,NOR,2017,49,832,NA,830,2,0.2
Norvège,NOR,2017,50,844,NA,825,19,2.3
Norvège,NOR,2017,51,897,NA,848,49,5.8
Norvège,NOR,2017,52,891,NA,887,4,0.5
Norvège,NOR,2018,1,938,NA,921,17,1.8
Norvège,NOR,2018,2,872,NA,903,-31,-3.4
Norvège,NOR,2018,3,945,NA,906,39,4.3
Norvège,NOR,2018,4,857,NA,874,-17,-1.9
Norvège,NOR,2018,5,881,NA,891,-10,-1.1
Norvège,NOR,2018,6,904,NA,856,48,5.6
Norvège,NOR,2018,7,927,NA,878,49,5.6
Norvège,NOR,2018,8,917,NA,852,65,7.6
Norvège,NOR,2018,9,907,NA,866,41,4.7
Norvège,NOR,2018,10,950,NA,842,108,12.8
Norvège,NOR,2018,11,867,NA,826,41,5
Norvège,NOR,2018,12,905,NA,825,80,9.7
Norvège,NOR,2018,13,807,NA,778,29,3.7
Norvège,NOR,2018,14,819,NA,803,16,2
Norvège,NOR,2018,15,827,NA,783,44,5.6
Norvège,NOR,2018,16,778,NA,763,15,2
Norvège,NOR,2018,17,781,NA,788,-7,-0.9
Norvège,NOR,2018,18,756,NA,756,0,0
Norvège,NOR,2018,19,738,NA,738,0,0
Norvège,NOR,2018,20,714,NA,729,-15,-2.1
Norvège,NOR,2018,21,692,NA,720,-28,-3.9
Norvège,NOR,2018,22,757,NA,713,44,6.2
Norvège,NOR,2018,23,713,NA,703,10,1.4
Norvège,NOR,2018,24,671,NA,717,-46,-6.4
Norvège,NOR,2018,25,703,NA,727,-24,-3.3
Norvège,NOR,2018,26,741,NA,730,11,1.5
Norvège,NOR,2018,27,776,NA,756,20,2.6
Norvège,NOR,2018,28,737,NA,724,13,1.8
Norvège,NOR,2018,29,720,NA,724,-4,-0.6
Norvège,NOR,2018,30,773,NA,736,37,5
Norvège,NOR,2018,31,677,NA,701,-24,-3.4
Norvège,NOR,2018,32,705,NA,723,-18,-2.5
Norvège,NOR,2018,33,694,NA,712,-18,-2.5
Norvège,NOR,2018,34,754,NA,714,40,5.6
Norvège,NOR,2018,35,715,NA,737,-22,-3
Norvège,NOR,2018,36,694,NA,719,-25,-3.5
Norvège,NOR,2018,37,705,NA,708,-3,-0.4
Norvège,NOR,2018,38,720,NA,713,7,1
Norvège,NOR,2018,39,712,NA,746,-34,-4.6
Norvège,NOR,2018,40,701,NA,722,-21,-2.9
Norvège,NOR,2018,41,714,NA,749,-35,-4.7
Norvège,NOR,2018,42,744,NA,751,-7,-0.9
Norvège,NOR,2018,43,696,NA,764,-68,-8.9
Norvège,NOR,2018,44,814,NA,756,58,7.7
Norvège,NOR,2018,45,776,NA,769,7,0.9
Norvège,NOR,2018,46,736,NA,790,-54,-6.8
Norvège,NOR,2018,47,720,NA,788,-68,-8.6
Norvège,NOR,2018,48,802,NA,785,17,2.2
Norvège,NOR,2018,49,821,NA,830,-9,-1.1
Norvège,NOR,2018,50,759,NA,825,-66,-8
Norvège,NOR,2018,51,802,NA,848,-46,-5.4
Norvège,NOR,2018,52,871,NA,887,-16,-1.8
Norvège,NOR,2019,1,871,NA,921,-50,-5.4
Norvège,NOR,2019,2,827,NA,903,-76,-8.4
Norvège,NOR,2019,3,811,NA,906,-95,-10.5
Norvège,NOR,2019,4,834,NA,874,-40,-4.6
Norvège,NOR,2019,5,889,NA,891,-2,-0.2
Norvège,NOR,2019,6,843,NA,856,-13,-1.5
Norvège,NOR,2019,7,914,NA,878,36,4.1
Norvège,NOR,2019,8,828,NA,852,-24,-2.8
Norvège,NOR,2019,9,819,NA,866,-47,-5.4
Norvège,NOR,2019,10,833,NA,842,-9,-1.1
Norvège,NOR,2019,11,836,NA,826,10,1.2
Norvège,NOR,2019,12,805,NA,825,-20,-2.4
Norvège,NOR,2019,13,790,NA,778,12,1.5
Norvège,NOR,2019,14,781,NA,803,-22,-2.7
Norvège,NOR,2019,15,757,NA,783,-26,-3.3
Norvège,NOR,2019,16,761,NA,763,-2,-0.3
Norvège,NOR,2019,17,799,NA,788,11,1.4
Norvège,NOR,2019,18,773,NA,756,17,2.2
Norvège,NOR,2019,19,772,NA,738,34,4.6
Norvège,NOR,2019,20,732,NA,729,3,0.4
Norvège,NOR,2019,21,741,NA,720,21,2.9
Norvège,NOR,2019,22,728,NA,713,15,2.1
Norvège,NOR,2019,23,707,NA,703,4,0.6
Norvège,NOR,2019,24,735,NA,717,18,2.5
Norvège,NOR,2019,25,723,NA,727,-4,-0.6
Norvège,NOR,2019,26,767,NA,730,37,5.1
Norvège,NOR,2019,27,735,NA,756,-21,-2.8
Norvège,NOR,2019,28,732,NA,724,8,1.1
Norvège,NOR,2019,29,741,NA,724,17,2.3
Norvège,NOR,2019,30,721,NA,736,-15,-2
Norvège,NOR,2019,31,727,NA,701,26,3.7
Norvège,NOR,2019,32,705,NA,723,-18,-2.5
Norvège,NOR,2019,33,733,NA,712,21,2.9
Norvège,NOR,2019,34,677,NA,714,-37,-5.2
Norvège,NOR,2019,35,779,NA,737,42,5.7
Norvège,NOR,2019,36,714,NA,719,-5,-0.7
Norvège,NOR,2019,37,707,NA,708,-1,-0.1
Norvège,NOR,2019,38,755,NA,713,42,5.9
Norvège,NOR,2019,39,818,NA,746,72,9.7
Norvège,NOR,2019,40,711,NA,722,-11,-1.5
Norvège,NOR,2019,41,786,NA,749,37,4.9
Norvège,NOR,2019,42,782,NA,751,31,4.1
Norvège,NOR,2019,43,794,NA,764,30,3.9
Norvège,NOR,2019,44,774,NA,756,18,2.4
Norvège,NOR,2019,45,786,NA,769,17,2.2
Norvège,NOR,2019,46,846,NA,790,56,7.1
Norvège,NOR,2019,47,784,NA,788,-4,-0.5
Norvège,NOR,2019,48,778,NA,785,-7,-0.9
Norvège,NOR,2019,49,850,NA,830,20,2.4
Norvège,NOR,2019,50,780,NA,825,-45,-5.5
Norvège,NOR,2019,51,772,NA,848,-76,-9
Norvège,NOR,2019,52,804,NA,887,-83,-9.4
Norvège,NOR,2020,1,860,0,921,-61,-6.6
Norvège,NOR,2020,2,948,0,903,45,5
Norvège,NOR,2020,3,835,0,906,-71,-7.8
Norvège,NOR,2020,4,862,0,874,-12,-1.4
Norvège,NOR,2020,5,815,0,891,-76,-8.5
Norvège,NOR,2020,6,796,0,856,-60,-7
Norvège,NOR,2020,7,856,0,878,-22,-2.5
Norvège,NOR,2020,8,811,0,852,-41,-4.8
Norvège,NOR,2020,9,838,0,866,-28,-3.2
Norvège,NOR,2020,10,796,0,842,-46,-5.5
Norvège,NOR,2020,11,821,3,826,-5,-0.6
Norvège,NOR,2020,12,800,5,825,-25,-3
Norvège,NOR,2020,13,848,18,778,70,9
Norvège,NOR,2020,14,823,33,803,20,2.5
Norvège,NOR,2020,15,835,55,783,52,6.6
Norvège,NOR,2020,16,801,40,763,38,5
Norvège,NOR,2020,17,766,39,788,-22,-2.8
Norvège,NOR,2020,18,739,15,756,-17,-2.2
Norvège,NOR,2020,19,728,16,738,-10,-1.4
Norvège,NOR,2020,20,658,9,729,-71,-9.7
Norvège,NOR,2020,21,705,2,720,-15,-2.1
Norvège,NOR,2020,22,597,1,713,-116,-16.3
Portugal,PRT,2016,1,2321,NA,2790,-469,-16.8
Portugal,PRT,2016,2,2332,NA,2746,-414,-15.1
Portugal,PRT,2016,3,2456,NA,2782,-326,-11.7
Portugal,PRT,2016,4,2332,NA,2760,-428,-15.5
Portugal,PRT,2016,5,2271,NA,2631,-360,-13.7
Portugal,PRT,2016,6,2351,NA,2592,-241,-9.3
Portugal,PRT,2016,7,2345,NA,2560,-215,-8.4
Portugal,PRT,2016,8,2296,NA,2464,-168,-6.8
Portugal,PRT,2016,9,2391,NA,2404,-13,-0.5
Portugal,PRT,2016,10,2380,NA,2311,69,3
Portugal,PRT,2016,11,2288,NA,2267,21,0.9
Portugal,PRT,2016,12,2271,NA,2194,77,3.5
Portugal,PRT,2016,13,2214,NA,2180,34,1.6
Portugal,PRT,2016,14,2225,NA,2187,38,1.7
Portugal,PRT,2016,15,2166,NA,2152,14,0.7
Portugal,PRT,2016,16,1989,NA,2027,-38,-1.9
Portugal,PRT,2016,17,2025,NA,2032,-7,-0.3
Portugal,PRT,2016,18,1954,NA,2014,-60,-3
Portugal,PRT,2016,19,1849,NA,1913,-64,-3.3
Portugal,PRT,2016,20,2045,NA,1969,76,3.9
Portugal,PRT,2016,21,1971,NA,1948,23,1.2
Portugal,PRT,2016,22,1983,NA,1907,76,4
Portugal,PRT,2016,23,1906,NA,1888,18,1
Portugal,PRT,2016,24,1799,NA,1892,-93,-4.9
Portugal,PRT,2016,25,1916,NA,2019,-103,-5.1
Portugal,PRT,2016,26,1893,NA,1883,10,0.5
Portugal,PRT,2016,27,1913,NA,1839,74,4
Portugal,PRT,2016,28,1934,NA,1852,82,4.4
Portugal,PRT,2016,29,1958,NA,1846,112,6.1
Portugal,PRT,2016,30,2054,NA,1880,174,9.3
Portugal,PRT,2016,31,1864,NA,1929,-65,-3.4
Portugal,PRT,2016,32,2091,NA,1967,124,6.3
Portugal,PRT,2016,33,1879,NA,1842,37,2
Portugal,PRT,2016,34,1914,NA,1943,-29,-1.5
Portugal,PRT,2016,35,1873,NA,1808,65,3.6
Portugal,PRT,2016,36,1864,NA,1854,10,0.5
Portugal,PRT,2016,37,1707,NA,1778,-71,-4
Portugal,PRT,2016,38,1835,NA,1848,-13,-0.7
Portugal,PRT,2016,39,1852,NA,1862,-10,-0.5
Portugal,PRT,2016,40,1856,NA,1908,-52,-2.7
Portugal,PRT,2016,41,1879,NA,1888,-9,-0.5
Portugal,PRT,2016,42,2026,NA,1970,56,2.8
Portugal,PRT,2016,43,1971,NA,2008,-37,-1.8
Portugal,PRT,2016,44,1939,NA,2008,-69,-3.4
Portugal,PRT,2016,45,2040,NA,2043,-3,-0.1
Portugal,PRT,2016,46,2127,NA,2132,-5,-0.2
Portugal,PRT,2016,47,2197,NA,2167,30,1.4
Portugal,PRT,2016,48,2388,NA,2238,150,6.7
Portugal,PRT,2016,49,2363,NA,2276,87,3.8
Portugal,PRT,2016,50,2526,NA,2350,176,7.5
Portugal,PRT,2016,51,2809,NA,2463,346,14
Portugal,PRT,2016,52,3200,NA,2657,543,20.4
Portugal,PRT,2017,1,3366,NA,2790,576,20.6
Portugal,PRT,2017,2,2967,NA,2746,221,8
Portugal,PRT,2017,3,2880,NA,2782,98,3.5
Portugal,PRT,2017,4,2995,NA,2760,235,8.5
Portugal,PRT,2017,5,2736,NA,2631,105,4
Portugal,PRT,2017,6,2453,NA,2592,-139,-5.4
Portugal,PRT,2017,7,2369,NA,2560,-191,-7.5
Portugal,PRT,2017,8,2237,NA,2464,-227,-9.2
Portugal,PRT,2017,9,2129,NA,2404,-275,-11.4
Portugal,PRT,2017,10,2149,NA,2311,-162,-7
Portugal,PRT,2017,11,2151,NA,2267,-116,-5.1
Portugal,PRT,2017,12,2074,NA,2194,-120,-5.5
Portugal,PRT,2017,13,2015,NA,2180,-165,-7.6
Portugal,PRT,2017,14,2071,NA,2187,-116,-5.3
Portugal,PRT,2017,15,2033,NA,2152,-119,-5.5
Portugal,PRT,2017,16,1825,NA,2027,-202,-10
Portugal,PRT,2017,17,1902,NA,2032,-130,-6.4
Portugal,PRT,2017,18,2011,NA,2014,-3,-0.1
Portugal,PRT,2017,19,1846,NA,1913,-67,-3.5
Portugal,PRT,2017,20,1833,NA,1969,-136,-6.9
Portugal,PRT,2017,21,1922,NA,1948,-26,-1.3
Portugal,PRT,2017,22,1815,NA,1907,-92,-4.8
Portugal,PRT,2017,23,1826,NA,1888,-62,-3.3
Portugal,PRT,2017,24,1969,NA,1892,77,4.1
Portugal,PRT,2017,25,2139,NA,2019,120,5.9
Portugal,PRT,2017,26,1784,NA,1883,-99,-5.3
Portugal,PRT,2017,27,1796,NA,1839,-43,-2.3
Portugal,PRT,2017,28,1806,NA,1852,-46,-2.5
Portugal,PRT,2017,29,1790,NA,1846,-56,-3
Portugal,PRT,2017,30,1799,NA,1880,-81,-4.3
Portugal,PRT,2017,31,1759,NA,1929,-170,-8.8
Portugal,PRT,2017,32,1739,NA,1967,-228,-11.6
Portugal,PRT,2017,33,1781,NA,1842,-61,-3.3
Portugal,PRT,2017,34,1960,NA,1943,17,0.9
Portugal,PRT,2017,35,1711,NA,1808,-97,-5.4
Portugal,PRT,2017,36,1783,NA,1854,-71,-3.8
Portugal,PRT,2017,37,1801,NA,1778,23,1.3
Portugal,PRT,2017,38,1793,NA,1848,-55,-3
Portugal,PRT,2017,39,1945,NA,1862,83,4.5
Portugal,PRT,2017,40,1983,NA,1908,75,3.9
Portugal,PRT,2017,41,1877,NA,1888,-11,-0.6
Portugal,PRT,2017,42,2004,NA,1970,34,1.7
Portugal,PRT,2017,43,1932,NA,2008,-76,-3.8
Portugal,PRT,2017,44,1918,NA,2008,-90,-4.5
Portugal,PRT,2017,45,1910,NA,2043,-133,-6.5
Portugal,PRT,2017,46,2161,NA,2132,29,1.4
Portugal,PRT,2017,47,2168,NA,2167,1,0
Portugal,PRT,2017,48,2193,NA,2238,-45,-2
Portugal,PRT,2017,49,2465,NA,2276,189,8.3
Portugal,PRT,2017,50,2455,NA,2350,105,4.5
Portugal,PRT,2017,51,2510,NA,2463,47,1.9
Portugal,PRT,2017,52,2747,NA,2657,90,3.4
Portugal,PRT,2018,1,2851,NA,2790,61,2.2
Portugal,PRT,2018,2,2803,NA,2746,57,2.1
Portugal,PRT,2018,3,2805,NA,2782,23,0.8
Portugal,PRT,2018,4,2693,NA,2760,-67,-2.4
Portugal,PRT,2018,5,2619,NA,2631,-12,-0.5
Portugal,PRT,2018,6,2783,NA,2592,191,7.4
Portugal,PRT,2018,7,2815,NA,2560,255,10
Portugal,PRT,2018,8,2777,NA,2464,313,12.7
Portugal,PRT,2018,9,2656,NA,2404,252,10.5
Portugal,PRT,2018,10,2387,NA,2311,76,3.3
Portugal,PRT,2018,11,2371,NA,2267,104,4.6
Portugal,PRT,2018,12,2234,NA,2194,40,1.8
Portugal,PRT,2018,13,2356,NA,2180,176,8.1
Portugal,PRT,2018,14,2354,NA,2187,167,7.6
Portugal,PRT,2018,15,2276,NA,2152,124,5.8
Portugal,PRT,2018,16,2197,NA,2027,170,8.4
Portugal,PRT,2018,17,2117,NA,2032,85,4.2
Portugal,PRT,2018,18,2012,NA,2014,-2,-0.1
Portugal,PRT,2018,19,1970,NA,1913,57,3
Portugal,PRT,2018,20,2066,NA,1969,97,4.9
Portugal,PRT,2018,21,1982,NA,1948,34,1.7
Portugal,PRT,2018,22,1883,NA,1907,-24,-1.3
Portugal,PRT,2018,23,1977,NA,1888,89,4.7
Portugal,PRT,2018,24,1928,NA,1892,36,1.9
Portugal,PRT,2018,25,2104,NA,2019,85,4.2
Portugal,PRT,2018,26,1936,NA,1883,53,2.8
Portugal,PRT,2018,27,1765,NA,1839,-74,-4
Portugal,PRT,2018,28,1771,NA,1852,-81,-4.4
Portugal,PRT,2018,29,1816,NA,1846,-30,-1.6
Portugal,PRT,2018,30,1824,NA,1880,-56,-3
Portugal,PRT,2018,31,2250,NA,1929,321,16.6
Portugal,PRT,2018,32,2199,NA,1967,232,11.8
Portugal,PRT,2018,33,1939,NA,1842,97,5.3
Portugal,PRT,2018,34,1960,NA,1943,17,0.9
Portugal,PRT,2018,35,1766,NA,1808,-42,-2.3
Portugal,PRT,2018,36,1837,NA,1854,-17,-0.9
Portugal,PRT,2018,37,1796,NA,1778,18,1
Portugal,PRT,2018,38,1867,NA,1848,19,1
Portugal,PRT,2018,39,1828,NA,1862,-34,-1.8
Portugal,PRT,2018,40,1890,NA,1908,-18,-0.9
Portugal,PRT,2018,41,1935,NA,1888,47,2.5
Portugal,PRT,2018,42,1943,NA,1970,-27,-1.4
Portugal,PRT,2018,43,1996,NA,2008,-12,-0.6
Portugal,PRT,2018,44,2043,NA,2008,35,1.7
Portugal,PRT,2018,45,2124,NA,2043,81,4
Portugal,PRT,2018,46,2093,NA,2132,-39,-1.8
Portugal,PRT,2018,47,2071,NA,2167,-96,-4.4
Portugal,PRT,2018,48,2132,NA,2238,-106,-4.7
Portugal,PRT,2018,49,2150,NA,2276,-126,-5.5
Portugal,PRT,2018,50,2129,NA,2350,-221,-9.4
Portugal,PRT,2018,51,2249,NA,2463,-214,-8.7
Portugal,PRT,2018,52,2367,NA,2657,-290,-10.9
Portugal,PRT,2019,1,2621,NA,2790,-169,-6.1
Portugal,PRT,2019,2,2884,NA,2746,138,5
Portugal,PRT,2019,3,2985,NA,2782,203,7.3
Portugal,PRT,2019,4,3021,NA,2760,261,9.5
Portugal,PRT,2019,5,2899,NA,2631,268,10.2
Portugal,PRT,2019,6,2779,NA,2592,187,7.2
Portugal,PRT,2019,7,2711,NA,2560,151,5.9
Portugal,PRT,2019,8,2546,NA,2464,82,3.3
Portugal,PRT,2019,9,2441,NA,2404,37,1.5
Portugal,PRT,2019,10,2329,NA,2311,18,0.8
Portugal,PRT,2019,11,2258,NA,2267,-9,-0.4
Portugal,PRT,2019,12,2199,NA,2194,5,0.2
Portugal,PRT,2019,13,2135,NA,2180,-45,-2.1
Portugal,PRT,2019,14,2097,NA,2187,-90,-4.1
Portugal,PRT,2019,15,2132,NA,2152,-20,-0.9
Portugal,PRT,2019,16,2096,NA,2027,69,3.4
Portugal,PRT,2019,17,2084,NA,2032,52,2.6
Portugal,PRT,2019,18,2081,NA,2014,67,3.3
Portugal,PRT,2019,19,1988,NA,1913,75,3.9
Portugal,PRT,2019,20,1931,NA,1969,-38,-1.9
Portugal,PRT,2019,21,1919,NA,1948,-29,-1.5
Portugal,PRT,2019,22,1948,NA,1907,41,2.1
Portugal,PRT,2019,23,1841,NA,1888,-47,-2.5
Portugal,PRT,2019,24,1873,NA,1892,-19,-1
Portugal,PRT,2019,25,1916,NA,2019,-103,-5.1
Portugal,PRT,2019,26,1919,NA,1883,36,1.9
Portugal,PRT,2019,27,1882,NA,1839,43,2.3
Portugal,PRT,2019,28,1898,NA,1852,46,2.5
Portugal,PRT,2019,29,1821,NA,1846,-25,-1.4
Portugal,PRT,2019,30,1841,NA,1880,-39,-2.1
Portugal,PRT,2019,31,1843,NA,1929,-86,-4.5
Portugal,PRT,2019,32,1838,NA,1967,-129,-6.6
Portugal,PRT,2019,33,1769,NA,1842,-73,-4
Portugal,PRT,2019,34,1938,NA,1943,-5,-0.3
Portugal,PRT,2019,35,1880,NA,1808,72,4
Portugal,PRT,2019,36,1933,NA,1854,79,4.3
Portugal,PRT,2019,37,1808,NA,1778,30,1.7
Portugal,PRT,2019,38,1899,NA,1848,51,2.8
Portugal,PRT,2019,39,1822,NA,1862,-40,-2.1
Portugal,PRT,2019,40,1901,NA,1908,-7,-0.4
Portugal,PRT,2019,41,1860,NA,1888,-28,-1.5
Portugal,PRT,2019,42,1909,NA,1970,-61,-3.1
Portugal,PRT,2019,43,2131,NA,2008,123,6.1
Portugal,PRT,2019,44,2134,NA,2008,126,6.3
Portugal,PRT,2019,45,2097,NA,2043,54,2.6
Portugal,PRT,2019,46,2148,NA,2132,16,0.8
Portugal,PRT,2019,47,2233,NA,2167,66,3
Portugal,PRT,2019,48,2241,NA,2238,3,0.1
Portugal,PRT,2019,49,2128,NA,2276,-148,-6.5
Portugal,PRT,2019,50,2290,NA,2350,-60,-2.6
Portugal,PRT,2019,51,2284,NA,2463,-179,-7.3
Portugal,PRT,2019,52,2313,NA,2657,-344,-12.9
Portugal,PRT,2020,1,2498,NA,2790,-292,-10.5
Portugal,PRT,2020,2,2654,NA,2746,-92,-3.4
Portugal,PRT,2020,3,2762,NA,2782,-20,-0.7
Portugal,PRT,2020,4,2662,NA,2760,-98,-3.6
Portugal,PRT,2020,5,2678,NA,2631,47,1.8
Portugal,PRT,2020,6,2476,NA,2592,-116,-4.5
Portugal,PRT,2020,7,2274,NA,2560,-286,-11.2
Portugal,PRT,2020,8,2356,NA,2464,-108,-4.4
Portugal,PRT,2020,9,2299,0,2404,-105,-4.4
Portugal,PRT,2020,10,2174,0,2311,-137,-5.9
Portugal,PRT,2020,11,2343,0,2267,76,3.4
Portugal,PRT,2020,12,2431,23,2194,237,10.8
Portugal,PRT,2020,13,2536,117,2180,356,16.3
Portugal,PRT,2020,14,2650,171,2187,463,21.2
Portugal,PRT,2020,15,2603,224,2152,451,21
Portugal,PRT,2020,16,2382,200,2027,355,17.5
Portugal,PRT,2020,17,2304,213,2032,272,13.4
Portugal,PRT,2020,18,2157,115,2014,143,7.1
Portugal,PRT,2020,19,2160,81,1913,247,12.9
Portugal,PRT,2020,20,2049,87,1969,80,4.1
Portugal,PRT,2020,21,2043,99,1948,95,4.9
Portugal,PRT,2020,22,2284,94,1907,377,19.8
Portugal,PRT,2020,23,1917,61,1888,29,1.5
Slovaquie,SVK,2016,1,1072,NA,1170,-98,-8.4
Slovaquie,SVK,2016,2,948,NA,1150,-202,-17.6
Slovaquie,SVK,2016,3,1026,NA,1198,-172,-14.4
Slovaquie,SVK,2016,4,982,NA,1142,-160,-14
Slovaquie,SVK,2016,5,1045,NA,1203,-158,-13.1
Slovaquie,SVK,2016,6,1041,NA,1185,-144,-12.2
Slovaquie,SVK,2016,7,1051,NA,1167,-116,-9.9
Slovaquie,SVK,2016,8,1023,NA,1171,-148,-12.6
Slovaquie,SVK,2016,9,1003,NA,1181,-178,-15.1
Slovaquie,SVK,2016,10,1009,NA,1142,-133,-11.6
Slovaquie,SVK,2016,11,1032,NA,1081,-49,-4.5
Slovaquie,SVK,2016,12,1026,NA,1074,-48,-4.5
Slovaquie,SVK,2016,13,999,NA,1042,-43,-4.1
Slovaquie,SVK,2016,14,1017,NA,1011,6,0.6
Slovaquie,SVK,2016,15,971,NA,1034,-63,-6.1
Slovaquie,SVK,2016,16,1010,NA,986,24,2.4
Slovaquie,SVK,2016,17,988,NA,996,-8,-0.8
Slovaquie,SVK,2016,18,1019,NA,979,40,4.1
Slovaquie,SVK,2016,19,988,NA,954,34,3.6
Slovaquie,SVK,2016,20,934,NA,952,-18,-1.9
Slovaquie,SVK,2016,21,1004,NA,957,47,4.9
Slovaquie,SVK,2016,22,984,NA,960,24,2.5
Slovaquie,SVK,2016,23,885,NA,898,-13,-1.4
Slovaquie,SVK,2016,24,898,NA,964,-66,-6.8
Slovaquie,SVK,2016,25,1056,NA,966,90,9.3
Slovaquie,SVK,2016,26,899,NA,930,-31,-3.3
Slovaquie,SVK,2016,27,909,NA,920,-11,-1.2
Slovaquie,SVK,2016,28,958,NA,926,32,3.5
Slovaquie,SVK,2016,29,937,NA,956,-19,-2
Slovaquie,SVK,2016,30,933,NA,996,-63,-6.3
Slovaquie,SVK,2016,31,904,NA,1005,-101,-10
Slovaquie,SVK,2016,32,874,NA,949,-75,-7.9
Slovaquie,SVK,2016,33,937,NA,921,16,1.7
Slovaquie,SVK,2016,34,909,NA,938,-29,-3.1
Slovaquie,SVK,2016,35,934,NA,959,-25,-2.6
Slovaquie,SVK,2016,36,954,NA,950,4,0.4
Slovaquie,SVK,2016,37,1000,NA,960,40,4.2
Slovaquie,SVK,2016,38,948,NA,972,-24,-2.5
Slovaquie,SVK,2016,39,1003,NA,1002,1,0.1
Slovaquie,SVK,2016,40,1029,NA,1011,18,1.8
Slovaquie,SVK,2016,41,992,NA,998,-6,-0.6
Slovaquie,SVK,2016,42,1071,NA,1019,52,5.1
Slovaquie,SVK,2016,43,1064,NA,992,72,7.3
Slovaquie,SVK,2016,44,1028,NA,992,36,3.6
Slovaquie,SVK,2016,45,1017,NA,1006,11,1.1
Slovaquie,SVK,2016,46,1063,NA,1014,49,4.8
Slovaquie,SVK,2016,47,1082,NA,1022,60,5.9
Slovaquie,SVK,2016,48,1067,NA,1028,39,3.8
Slovaquie,SVK,2016,49,984,NA,983,1,0.1
Slovaquie,SVK,2016,50,1067,NA,1026,41,4
Slovaquie,SVK,2016,51,1200,NA,1108,92,8.3
Slovaquie,SVK,2016,52,1311,NA,1111,200,18
Slovaquie,SVK,2017,1,1411,NA,1170,241,20.6
Slovaquie,SVK,2017,2,1410,NA,1150,260,22.6
Slovaquie,SVK,2017,3,1390,NA,1198,192,16
Slovaquie,SVK,2017,4,1355,NA,1142,213,18.7
Slovaquie,SVK,2017,5,1339,NA,1203,136,11.3
Slovaquie,SVK,2017,6,1202,NA,1185,17,1.4
Slovaquie,SVK,2017,7,1224,NA,1167,57,4.9
Slovaquie,SVK,2017,8,1115,NA,1171,-56,-4.8
Slovaquie,SVK,2017,9,1159,NA,1181,-22,-1.9
Slovaquie,SVK,2017,10,1002,NA,1142,-140,-12.3
Slovaquie,SVK,2017,11,1016,NA,1081,-65,-6
Slovaquie,SVK,2017,12,1092,NA,1074,18,1.7
Slovaquie,SVK,2017,13,1017,NA,1042,-25,-2.4
Slovaquie,SVK,2017,14,989,NA,1011,-22,-2.2
Slovaquie,SVK,2017,15,1024,NA,1034,-10,-1
Slovaquie,SVK,2017,16,1008,NA,986,22,2.2
Slovaquie,SVK,2017,17,1023,NA,996,27,2.7
Slovaquie,SVK,2017,18,955,NA,979,-24,-2.5
Slovaquie,SVK,2017,19,919,NA,954,-35,-3.7
Slovaquie,SVK,2017,20,925,NA,952,-27,-2.8
Slovaquie,SVK,2017,21,916,NA,957,-41,-4.3
Slovaquie,SVK,2017,22,949,NA,960,-11,-1.1
Slovaquie,SVK,2017,23,858,NA,898,-40,-4.5
Slovaquie,SVK,2017,24,918,NA,964,-46,-4.8
Slovaquie,SVK,2017,25,923,NA,966,-43,-4.5
Slovaquie,SVK,2017,26,977,NA,930,47,5.1
Slovaquie,SVK,2017,27,915,NA,920,-5,-0.5
Slovaquie,SVK,2017,28,900,NA,926,-26,-2.8
Slovaquie,SVK,2017,29,969,NA,956,13,1.4
Slovaquie,SVK,2017,30,948,NA,996,-48,-4.8
Slovaquie,SVK,2017,31,1064,NA,1005,59,5.9
Slovaquie,SVK,2017,32,990,NA,949,41,4.3
Slovaquie,SVK,2017,33,958,NA,921,37,4
Slovaquie,SVK,2017,34,918,NA,938,-20,-2.1
Slovaquie,SVK,2017,35,931,NA,959,-28,-2.9
Slovaquie,SVK,2017,36,953,NA,950,3,0.3
Slovaquie,SVK,2017,37,951,NA,960,-9,-0.9
Slovaquie,SVK,2017,38,977,NA,972,5,0.5
Slovaquie,SVK,2017,39,1023,NA,1002,21,2.1
Slovaquie,SVK,2017,40,1039,NA,1011,28,2.8
Slovaquie,SVK,2017,41,1036,NA,998,38,3.8
Slovaquie,SVK,2017,42,1004,NA,1019,-15,-1.5
Slovaquie,SVK,2017,43,919,NA,992,-73,-7.4
Slovaquie,SVK,2017,44,984,NA,992,-8,-0.8
Slovaquie,SVK,2017,45,990,NA,1006,-16,-1.6
Slovaquie,SVK,2017,46,998,NA,1014,-16,-1.6
Slovaquie,SVK,2017,47,997,NA,1022,-25,-2.4
Slovaquie,SVK,2017,48,1015,NA,1028,-13,-1.3
Slovaquie,SVK,2017,49,971,NA,983,-12,-1.2
Slovaquie,SVK,2017,50,1003,NA,1026,-23,-2.2
Slovaquie,SVK,2017,51,1051,NA,1108,-57,-5.1
Slovaquie,SVK,2017,52,1082,NA,1111,-29,-2.6
Slovaquie,SVK,2018,1,1094,NA,1170,-76,-6.5
Slovaquie,SVK,2018,2,1150,NA,1150,0,0
Slovaquie,SVK,2018,3,1198,NA,1198,0,0
Slovaquie,SVK,2018,4,1095,NA,1142,-47,-4.1
Slovaquie,SVK,2018,5,1205,NA,1203,2,0.2
Slovaquie,SVK,2018,6,1159,NA,1185,-26,-2.2
Slovaquie,SVK,2018,7,1140,NA,1167,-27,-2.3
Slovaquie,SVK,2018,8,1292,NA,1171,121,10.3
Slovaquie,SVK,2018,9,1353,NA,1181,172,14.6
Slovaquie,SVK,2018,10,1357,NA,1142,215,18.8
Slovaquie,SVK,2018,11,1165,NA,1081,84,7.8
Slovaquie,SVK,2018,12,1111,NA,1074,37,3.4
Slovaquie,SVK,2018,13,1128,NA,1042,86,8.3
Slovaquie,SVK,2018,14,1051,NA,1011,40,4
Slovaquie,SVK,2018,15,1070,NA,1034,36,3.5
Slovaquie,SVK,2018,16,944,NA,986,-42,-4.3
Slovaquie,SVK,2018,17,906,NA,996,-90,-9
Slovaquie,SVK,2018,18,963,NA,979,-16,-1.6
Slovaquie,SVK,2018,19,952,NA,954,-2,-0.2
Slovaquie,SVK,2018,20,1004,NA,952,52,5.5
Slovaquie,SVK,2018,21,986,NA,957,29,3
Slovaquie,SVK,2018,22,985,NA,960,25,2.6
Slovaquie,SVK,2018,23,922,NA,898,24,2.7
Slovaquie,SVK,2018,24,955,NA,964,-9,-0.9
Slovaquie,SVK,2018,25,891,NA,966,-75,-7.8
Slovaquie,SVK,2018,26,922,NA,930,-8,-0.9
Slovaquie,SVK,2018,27,946,NA,920,26,2.8
Slovaquie,SVK,2018,28,970,NA,926,44,4.8
Slovaquie,SVK,2018,29,969,NA,956,13,1.4
Slovaquie,SVK,2018,30,1080,NA,996,84,8.4
Slovaquie,SVK,2018,31,1110,NA,1005,105,10.4
Slovaquie,SVK,2018,32,991,NA,949,42,4.4
Slovaquie,SVK,2018,33,931,NA,921,10,1.1
Slovaquie,SVK,2018,34,961,NA,938,23,2.5
Slovaquie,SVK,2018,35,940,NA,959,-19,-2
Slovaquie,SVK,2018,36,999,NA,950,49,5.2
Slovaquie,SVK,2018,37,952,NA,960,-8,-0.8
Slovaquie,SVK,2018,38,1019,NA,972,47,4.8
Slovaquie,SVK,2018,39,1007,NA,1002,5,0.5
Slovaquie,SVK,2018,40,995,NA,1011,-16,-1.6
Slovaquie,SVK,2018,41,1022,NA,998,24,2.4
Slovaquie,SVK,2018,42,982,NA,1019,-37,-3.6
Slovaquie,SVK,2018,43,1043,NA,992,51,5.1
Slovaquie,SVK,2018,44,955,NA,992,-37,-3.7
Slovaquie,SVK,2018,45,1030,NA,1006,24,2.4
Slovaquie,SVK,2018,46,994,NA,1014,-20,-2
Slovaquie,SVK,2018,47,1021,NA,1022,-1,-0.1
Slovaquie,SVK,2018,48,1036,NA,1028,8,0.8
Slovaquie,SVK,2018,49,1009,NA,983,26,2.6
Slovaquie,SVK,2018,50,1034,NA,1026,8,0.8
Slovaquie,SVK,2018,51,1129,NA,1108,21,1.9
Slovaquie,SVK,2018,52,1014,NA,1111,-97,-8.7
Slovaquie,SVK,2019,1,1105,NA,1170,-65,-5.6
Slovaquie,SVK,2019,2,1094,NA,1150,-56,-4.9
Slovaquie,SVK,2019,3,1176,NA,1198,-22,-1.8
Slovaquie,SVK,2019,4,1135,NA,1142,-7,-0.6
Slovaquie,SVK,2019,5,1224,NA,1203,21,1.7
Slovaquie,SVK,2019,6,1339,NA,1185,154,13
Slovaquie,SVK,2019,7,1252,NA,1167,85,7.3
Slovaquie,SVK,2019,8,1254,NA,1171,83,7.1
Slovaquie,SVK,2019,9,1208,NA,1181,27,2.3
Slovaquie,SVK,2019,10,1200,NA,1142,58,5.1
Slovaquie,SVK,2019,11,1110,NA,1081,29,2.7
Slovaquie,SVK,2019,12,1068,NA,1074,-6,-0.6
Slovaquie,SVK,2019,13,1025,NA,1042,-17,-1.6
Slovaquie,SVK,2019,14,986,NA,1011,-25,-2.5
Slovaquie,SVK,2019,15,1073,NA,1034,39,3.8
Slovaquie,SVK,2019,16,984,NA,986,-2,-0.2
Slovaquie,SVK,2019,17,1065,NA,996,69,6.9
Slovaquie,SVK,2019,18,979,NA,979,0,0
Slovaquie,SVK,2019,19,955,NA,954,1,0.1
Slovaquie,SVK,2019,20,943,NA,952,-9,-0.9
Slovaquie,SVK,2019,21,922,NA,957,-35,-3.7
Slovaquie,SVK,2019,22,924,NA,960,-36,-3.8
Slovaquie,SVK,2019,23,929,NA,898,31,3.5
Slovaquie,SVK,2019,24,1086,NA,964,122,12.7
Slovaquie,SVK,2019,25,996,NA,966,30,3.1
Slovaquie,SVK,2019,26,924,NA,930,-6,-0.6
Slovaquie,SVK,2019,27,910,NA,920,-10,-1.1
Slovaquie,SVK,2019,28,876,NA,926,-50,-5.4
Slovaquie,SVK,2019,29,947,NA,956,-9,-0.9
Slovaquie,SVK,2019,30,1025,NA,996,29,2.9
Slovaquie,SVK,2019,31,941,NA,1005,-64,-6.4
Slovaquie,SVK,2019,32,941,NA,949,-8,-0.8
Slovaquie,SVK,2019,33,858,NA,921,-63,-6.8
Slovaquie,SVK,2019,34,963,NA,938,25,2.7
Slovaquie,SVK,2019,35,1032,NA,959,73,7.6
Slovaquie,SVK,2019,36,894,NA,950,-56,-5.9
Slovaquie,SVK,2019,37,936,NA,960,-24,-2.5
Slovaquie,SVK,2019,38,943,NA,972,-29,-3
Slovaquie,SVK,2019,39,976,NA,1002,-26,-2.6
Slovaquie,SVK,2019,40,980,NA,1011,-31,-3.1
Slovaquie,SVK,2019,41,943,NA,998,-55,-5.5
Slovaquie,SVK,2019,42,1020,NA,1019,1,0.1
Slovaquie,SVK,2019,43,941,NA,992,-51,-5.1
Slovaquie,SVK,2019,44,1001,NA,992,9,0.9
Slovaquie,SVK,2019,45,989,NA,1006,-17,-1.7
Slovaquie,SVK,2019,46,1003,NA,1014,-11,-1.1
Slovaquie,SVK,2019,47,986,NA,1022,-36,-3.5
Slovaquie,SVK,2019,48,994,NA,1028,-34,-3.3
Slovaquie,SVK,2019,49,969,NA,983,-14,-1.4
Slovaquie,SVK,2019,50,1002,NA,1026,-24,-2.3
Slovaquie,SVK,2019,51,1053,NA,1108,-55,-5
Slovaquie,SVK,2019,52,1036,NA,1111,-75,-6.8
Slovaquie,SVK,2020,1,1056,NA,1170,-114,-9.7
Slovaquie,SVK,2020,2,1097,NA,1150,-53,-4.6
Slovaquie,SVK,2020,3,1079,NA,1198,-119,-9.9
Slovaquie,SVK,2020,4,1097,NA,1142,-45,-3.9
Slovaquie,SVK,2020,5,1149,NA,1203,-54,-4.5
Slovaquie,SVK,2020,6,1091,NA,1185,-94,-7.9
Slovaquie,SVK,2020,7,1169,NA,1167,2,0.2
Slovaquie,SVK,2020,8,1078,NA,1171,-93,-7.9
Slovaquie,SVK,2020,9,1136,NA,1181,-45,-3.8
Slovaquie,SVK,2020,10,1108,0,1142,-34,-3
Slovaquie,SVK,2020,11,1093,0,1081,12,1.1
Slovaquie,SVK,2020,12,1163,0,1074,89,8.3
Slovaquie,SVK,2020,13,1040,0,1042,-2,-0.2
Slovaquie,SVK,2020,14,1023,2,1011,12,1.2
Slovaquie,SVK,2020,15,935,0,1034,-99,-9.6
Slovaquie,SVK,2020,16,915,11,986,-71,-7.2
Slovaquie,SVK,2020,17,920,5,996,-76,-7.6
Suède,SWE,2016,1,1860,NA,1988,-128,-6.4
Suède,SWE,2016,2,1914,NA,1949,-35,-1.8
Suède,SWE,2016,3,1958,NA,1950,8,0.4
Suède,SWE,2016,4,2006,NA,1918,88,4.6
Suède,SWE,2016,5,1909,NA,1864,45,2.4
Suède,SWE,2016,6,1837,NA,1896,-59,-3.1
Suède,SWE,2016,7,1838,NA,1909,-71,-3.7
Suède,SWE,2016,8,1845,NA,1962,-117,-6
Suède,SWE,2016,9,1861,NA,1952,-91,-4.7
Suède,SWE,2016,10,1810,NA,1884,-74,-3.9
Suède,SWE,2016,11,1800,NA,1892,-92,-4.9
Suède,SWE,2016,12,1795,NA,1779,16,0.9
Suède,SWE,2016,13,1778,NA,1793,-15,-0.8
Suède,SWE,2016,14,1705,NA,1796,-91,-5.1
Suède,SWE,2016,15,1773,NA,1722,51,3
Suède,SWE,2016,16,1771,NA,1740,31,1.8
Suède,SWE,2016,17,1604,NA,1678,-74,-4.4
Suède,SWE,2016,18,1619,NA,1647,-28,-1.7
Suède,SWE,2016,19,1586,NA,1631,-45,-2.8
Suède,SWE,2016,20,1565,NA,1548,17,1.1
Suède,SWE,2016,21,1550,NA,1536,14,0.9
Suède,SWE,2016,22,1541,NA,1546,-5,-0.3
Suède,SWE,2016,23,1462,NA,1517,-55,-3.6
Suède,SWE,2016,24,1541,NA,1504,37,2.5
Suède,SWE,2016,25,1573,NA,1522,51,3.4
Suède,SWE,2016,26,1541,NA,1568,-27,-1.7
Suède,SWE,2016,27,1549,NA,1556,-7,-0.4
Suède,SWE,2016,28,1605,NA,1568,37,2.4
Suède,SWE,2016,29,1616,NA,1584,32,2
Suède,SWE,2016,30,1630,NA,1568,62,4
Suède,SWE,2016,31,1574,NA,1581,-7,-0.4
Suède,SWE,2016,32,1574,NA,1531,43,2.8
Suède,SWE,2016,33,1567,NA,1526,41,2.7
Suède,SWE,2016,34,1567,NA,1533,34,2.2
Suède,SWE,2016,35,1686,NA,1620,66,4.1
Suède,SWE,2016,36,1556,NA,1552,4,0.3
Suède,SWE,2016,37,1536,NA,1550,-14,-0.9
Suède,SWE,2016,38,1531,NA,1570,-39,-2.5
Suède,SWE,2016,39,1601,NA,1584,17,1.1
Suède,SWE,2016,40,1598,NA,1638,-40,-2.4
Suède,SWE,2016,41,1662,NA,1682,-20,-1.2
Suède,SWE,2016,42,1750,NA,1640,110,6.7
Suède,SWE,2016,43,1626,NA,1664,-38,-2.3
Suède,SWE,2016,44,1718,NA,1705,13,0.8
Suède,SWE,2016,45,1717,NA,1666,51,3.1
Suède,SWE,2016,46,1771,NA,1685,86,5.1
Suède,SWE,2016,47,1702,NA,1662,40,2.4
Suède,SWE,2016,48,1790,NA,1750,40,2.3
Suède,SWE,2016,49,1842,NA,1781,61,3.4
Suède,SWE,2016,50,1858,NA,1774,84,4.7
Suède,SWE,2016,51,1868,NA,1812,56,3.1
Suède,SWE,2016,52,2012,NA,1854,158,8.5
Suède,SWE,2017,1,2149,NA,1988,161,8.1
Suède,SWE,2017,2,2122,NA,1949,173,8.9
Suède,SWE,2017,3,2060,NA,1950,110,5.6
Suède,SWE,2017,4,1910,NA,1918,-8,-0.4
Suède,SWE,2017,5,1883,NA,1864,19,1
Suède,SWE,2017,6,1881,NA,1896,-15,-0.8
Suède,SWE,2017,7,2010,NA,1909,101,5.3
Suède,SWE,2017,8,2069,NA,1962,107,5.5
Suède,SWE,2017,9,1989,NA,1952,37,1.9
Suède,SWE,2017,10,1830,NA,1884,-54,-2.9
Suède,SWE,2017,11,1849,NA,1892,-43,-2.3
Suède,SWE,2017,12,1692,NA,1779,-87,-4.9
Suède,SWE,2017,13,1782,NA,1793,-11,-0.6
Suède,SWE,2017,14,1794,NA,1796,-2,-0.1
Suède,SWE,2017,15,1719,NA,1722,-3,-0.2
Suède,SWE,2017,16,1768,NA,1740,28,1.6
Suède,SWE,2017,17,1772,NA,1678,94,5.6
Suède,SWE,2017,18,1696,NA,1647,49,3
Suède,SWE,2017,19,1724,NA,1631,93,5.7
Suède,SWE,2017,20,1584,NA,1548,36,2.3
Suède,SWE,2017,21,1646,NA,1536,110,7.2
Suède,SWE,2017,22,1620,NA,1546,74,4.8
Suède,SWE,2017,23,1549,NA,1517,32,2.1
Suède,SWE,2017,24,1590,NA,1504,86,5.7
Suède,SWE,2017,25,1491,NA,1522,-31,-2
Suède,SWE,2017,26,1587,NA,1568,19,1.2
Suède,SWE,2017,27,1549,NA,1556,-7,-0.4
Suède,SWE,2017,28,1525,NA,1568,-43,-2.7
Suède,SWE,2017,29,1512,NA,1584,-72,-4.5
Suède,SWE,2017,30,1484,NA,1568,-84,-5.4
Suède,SWE,2017,31,1536,NA,1581,-45,-2.8
Suède,SWE,2017,32,1552,NA,1531,21,1.4
Suède,SWE,2017,33,1545,NA,1526,19,1.2
Suède,SWE,2017,34,1527,NA,1533,-6,-0.4
Suède,SWE,2017,35,1568,NA,1620,-52,-3.2
Suède,SWE,2017,36,1596,NA,1552,44,2.8
Suède,SWE,2017,37,1590,NA,1550,40,2.6
Suède,SWE,2017,38,1562,NA,1570,-8,-0.5
Suède,SWE,2017,39,1532,NA,1584,-52,-3.3
Suède,SWE,2017,40,1708,NA,1638,70,4.3
Suède,SWE,2017,41,1695,NA,1682,13,0.8
Suède,SWE,2017,42,1648,NA,1640,8,0.5
Suède,SWE,2017,43,1644,NA,1664,-20,-1.2
Suède,SWE,2017,44,1757,NA,1705,52,3
Suède,SWE,2017,45,1608,NA,1666,-58,-3.5
Suède,SWE,2017,46,1753,NA,1685,68,4
Suède,SWE,2017,47,1700,NA,1662,38,2.3
Suède,SWE,2017,48,1740,NA,1750,-10,-0.6
Suède,SWE,2017,49,1765,NA,1781,-16,-0.9
Suède,SWE,2017,50,1797,NA,1774,23,1.3
Suède,SWE,2017,51,1815,NA,1812,3,0.2
Suède,SWE,2017,52,1929,NA,1854,75,4
Suède,SWE,2018,1,1998,NA,1988,10,0.5
Suède,SWE,2018,2,1941,NA,1949,-8,-0.4
Suède,SWE,2018,3,1945,NA,1950,-5,-0.3
Suède,SWE,2018,4,1928,NA,1918,10,0.5
Suède,SWE,2018,5,1854,NA,1864,-10,-0.5
Suède,SWE,2018,6,1983,NA,1896,87,4.6
Suède,SWE,2018,7,2024,NA,1909,115,6
Suède,SWE,2018,8,2116,NA,1962,154,7.8
Suède,SWE,2018,9,2187,NA,1952,235,12
Suède,SWE,2018,10,2204,NA,1884,320,17
Suède,SWE,2018,11,2089,NA,1892,197,10.4
Suède,SWE,2018,12,1997,NA,1779,218,12.3
Suède,SWE,2018,13,1948,NA,1793,155,8.6
Suède,SWE,2018,14,1988,NA,1796,192,10.7
Suède,SWE,2018,15,1782,NA,1722,60,3.5
Suède,SWE,2018,16,1687,NA,1740,-53,-3
Suède,SWE,2018,17,1639,NA,1678,-39,-2.3
Suède,SWE,2018,18,1661,NA,1647,14,0.9
Suède,SWE,2018,19,1572,NA,1631,-59,-3.6
Suède,SWE,2018,20,1486,NA,1548,-62,-4
Suède,SWE,2018,21,1460,NA,1536,-76,-4.9
Suède,SWE,2018,22,1481,NA,1546,-65,-4.2
Suède,SWE,2018,23,1513,NA,1517,-4,-0.3
Suède,SWE,2018,24,1441,NA,1504,-63,-4.2
Suède,SWE,2018,25,1500,NA,1522,-22,-1.4
Suède,SWE,2018,26,1633,NA,1568,65,4.1
Suède,SWE,2018,27,1588,NA,1556,32,2.1
Suède,SWE,2018,28,1585,NA,1568,17,1.1
Suède,SWE,2018,29,1724,NA,1584,140,8.8
Suède,SWE,2018,30,1642,NA,1568,74,4.7
Suède,SWE,2018,31,1723,NA,1581,142,9
Suède,SWE,2018,32,1450,NA,1531,-81,-5.3
Suède,SWE,2018,33,1505,NA,1526,-21,-1.4
Suède,SWE,2018,34,1495,NA,1533,-38,-2.5
Suède,SWE,2018,35,1584,NA,1620,-36,-2.2
Suède,SWE,2018,36,1617,NA,1552,65,4.2
Suède,SWE,2018,37,1516,NA,1550,-34,-2.2
Suède,SWE,2018,38,1645,NA,1570,75,4.8
Suède,SWE,2018,39,1553,NA,1584,-31,-2
Suède,SWE,2018,40,1606,NA,1638,-32,-2
Suède,SWE,2018,41,1715,NA,1682,33,2
Suède,SWE,2018,42,1542,NA,1640,-98,-6
Suède,SWE,2018,43,1660,NA,1664,-4,-0.2
Suède,SWE,2018,44,1706,NA,1705,1,0.1
Suède,SWE,2018,45,1640,NA,1666,-26,-1.6
Suède,SWE,2018,46,1541,NA,1685,-144,-8.5
Suède,SWE,2018,47,1534,NA,1662,-128,-7.7
Suède,SWE,2018,48,1780,NA,1750,30,1.7
Suède,SWE,2018,49,1787,NA,1781,6,0.3
Suède,SWE,2018,50,1720,NA,1774,-54,-3
Suède,SWE,2018,51,1741,NA,1812,-71,-3.9
Suède,SWE,2018,52,1758,NA,1854,-96,-5.2
Suède,SWE,2019,1,1943,NA,1988,-45,-2.3
Suède,SWE,2019,2,1820,NA,1949,-129,-6.6
Suède,SWE,2019,3,1839,NA,1950,-111,-5.7
Suède,SWE,2019,4,1828,NA,1918,-90,-4.7
Suède,SWE,2019,5,1812,NA,1864,-52,-2.8
Suède,SWE,2019,6,1882,NA,1896,-14,-0.7
Suède,SWE,2019,7,1764,NA,1909,-145,-7.6
Suède,SWE,2019,8,1820,NA,1962,-142,-7.2
Suède,SWE,2019,9,1772,NA,1952,-180,-9.2
Suède,SWE,2019,10,1690,NA,1884,-194,-10.3
Suède,SWE,2019,11,1829,NA,1892,-63,-3.3
Suède,SWE,2019,12,1632,NA,1779,-147,-8.3
Suède,SWE,2019,13,1665,NA,1793,-128,-7.1
Suède,SWE,2019,14,1698,NA,1796,-98,-5.5
Suède,SWE,2019,15,1612,NA,1722,-110,-6.4
Suède,SWE,2019,16,1736,NA,1740,-4,-0.2
Suède,SWE,2019,17,1698,NA,1678,20,1.2
Suède,SWE,2019,18,1613,NA,1647,-34,-2.1
Suède,SWE,2019,19,1643,NA,1631,12,0.7
Suède,SWE,2019,20,1557,NA,1548,9,0.6
Suède,SWE,2019,21,1486,NA,1536,-50,-3.3
Suède,SWE,2019,22,1541,NA,1546,-5,-0.3
Suède,SWE,2019,23,1544,NA,1517,27,1.8
Suède,SWE,2019,24,1444,NA,1504,-60,-4
Suède,SWE,2019,25,1526,NA,1522,4,0.3
Suède,SWE,2019,26,1512,NA,1568,-56,-3.6
Suède,SWE,2019,27,1537,NA,1556,-19,-1.2
Suède,SWE,2019,28,1558,NA,1568,-10,-0.6
Suède,SWE,2019,29,1482,NA,1584,-102,-6.4
Suède,SWE,2019,30,1514,NA,1568,-54,-3.4
Suède,SWE,2019,31,1491,NA,1581,-90,-5.7
Suède,SWE,2019,32,1548,NA,1531,17,1.1
Suède,SWE,2019,33,1486,NA,1526,-40,-2.6
Suède,SWE,2019,34,1542,NA,1533,9,0.6
Suède,SWE,2019,35,1642,NA,1620,22,1.4
Suède,SWE,2019,36,1441,NA,1552,-111,-7.2
Suède,SWE,2019,37,1559,NA,1550,9,0.6
Suède,SWE,2019,38,1540,NA,1570,-30,-1.9
Suède,SWE,2019,39,1648,NA,1584,64,4
Suède,SWE,2019,40,1638,NA,1638,0,0
Suède,SWE,2019,41,1654,NA,1682,-28,-1.7
Suède,SWE,2019,42,1622,NA,1640,-18,-1.1
Suède,SWE,2019,43,1724,NA,1664,60,3.6
Suède,SWE,2019,44,1638,NA,1705,-67,-3.9
Suède,SWE,2019,45,1698,NA,1666,32,1.9
Suède,SWE,2019,46,1674,NA,1685,-11,-0.7
Suède,SWE,2019,47,1712,NA,1662,50,3
Suède,SWE,2019,48,1688,NA,1750,-62,-3.5
Suède,SWE,2019,49,1731,NA,1781,-50,-2.8
Suède,SWE,2019,50,1719,NA,1774,-55,-3.1
Suède,SWE,2019,51,1826,NA,1812,14,0.8
Suède,SWE,2019,52,1718,NA,1854,-136,-7.3
Suède,SWE,2020,1,1819,0,1988,-169,-8.5
Suède,SWE,2020,2,1890,0,1949,-59,-3
Suède,SWE,2020,3,1826,0,1950,-124,-6.4
Suède,SWE,2020,4,1729,0,1918,-189,-9.9
Suède,SWE,2020,5,1847,0,1864,-17,-0.9
Suède,SWE,2020,6,1726,0,1896,-170,-9
Suède,SWE,2020,7,1824,0,1909,-85,-4.5
Suède,SWE,2020,8,1774,0,1962,-188,-9.6
Suède,SWE,2020,9,1778,0,1952,-174,-8.9
Suède,SWE,2020,10,1825,0,1884,-59,-3.1
Suède,SWE,2020,11,1728,7,1892,-164,-8.7
Suède,SWE,2020,12,1862,18,1779,83,4.7
Suède,SWE,2020,13,2037,121,1793,244,13.6
Suède,SWE,2020,14,2378,331,1796,582,32.4
Suède,SWE,2020,15,2564,442,1722,842,48.9
Suède,SWE,2020,16,2520,661,1740,780,44.8
Suède,SWE,2020,17,2266,694,1678,588,35
Suède,SWE,2020,18,2235,495,1647,588,35.7
Suède,SWE,2020,19,2175,487,1631,544,33.4
Suède,SWE,2020,20,1983,442,1548,435,28.1
Suède,SWE,2020,21,1911,331,1536,375,24.4
Suède,SWE,2020,22,1639,374,1546,93,6
Suède,SWE,2020,23,1710,291,1517,193,12.7
Suède,SWE,2020,24,1542,197,1504,38,2.5
